纟	糹
钅	釒
饣	飠
讠	訁
于	於
腊	臘
腊	腊
尸	屍
扎	扎
扎	紮
巨	巨
巨	鉅
占	佔
托	托
托	託
吊	吊
吊	弔
众	眾
汹	洶
杯	杯
杯	盃
杰	傑
杰	杰
昆	昆
昆	崑
仑	侖
仑	崙
亘	亘
亘	亙
迹	跡
迹	迹
恒	恒
恒	恆
葱	葱
葱	蔥
喂	餵
闲	閒
闲	閑
采	採
奸	奸
奸	姦
异	異
却	卻
并	並
并	併
厂	廠
卜	卜
卜	蔔
儿	兒
几	幾
几	几
了	了
了	瞭
干	幹
干	乾
干	干
亏	虧
才	纔
才	才
与	與
万	萬
万	万
千	千
千	韆
亿	億
个	個
么	麽
广	廣
门	門
义	義
卫	衛
飞	飛
习	習
马	馬
乡	鄉
丰	豐
丰	丰
开	開
无	無
云	雲
云	云
专	專
艺	藝
厅	廳
区	區
历	歷
历	曆
车	車
贝	貝
冈	岡
见	見
气	氣
长	長
仆	僕
仆	仆
币	幣
仅	僅
从	從
仓	倉
风	風
乌	烏
凤	鳳
为	爲
斗	斗
斗	鬥
忆	憶
计	計
订	訂
认	認
讥	譏
丑	醜
丑	丑
队	隊
办	辦
邓	鄧
劝	勸
双	雙
书	書
击	擊
扑	撲
节	節
术	術
术	术
厉	厲
龙	龍
灭	滅
轧	軋
东	東
卢	盧
业	業
旧	舊
帅	帥
归	歸
叶	葉
叶	叶
电	電
号	號
只	隻
只	只
叽	嘰
叹	嘆
们	們
仪	儀
丛	叢
尔	爾
乐	樂
处	處
冬	冬
冬	鼕
鸟	鳥
务	務
饥	飢
饥	饑
冯	馮
闪	閃
兰	蘭
汇	匯
汇	彙
头	頭
汉	漢
宁	寧
讨	討
写	寫
让	讓
礼	禮
训	訓
议	議
讯	訊
记	記
出	出
出	齣
辽	遼
边	邊
发	髮
发	發
圣	聖
对	對
台	臺
台	檯
台	颱
台	台
纠	糾
丝	絲
动	動
巩	鞏
执	執
扩	擴
扫	掃
场	場
扬	揚
亚	亞
朴	樸
朴	朴
机	機
权	權
过	過
协	協
压	壓
厌	厭
页	頁
夸	誇
夸	夸
夺	奪
达	達
夹	夾
轨	軌
尧	堯
划	划
划	劃
迈	邁
毕	畢
贞	貞
师	師
尘	塵
当	當
当	噹
吁	籲
吁	吁
吓	嚇
虫	蟲
曲	曲
曲	麯
团	團
团	糰
吗	嗎
屿	嶼
岁	歲
回	回
回	迴
岂	豈
则	則
刚	剛
网	網
朱	朱
朱	硃
迁	遷
乔	喬
伟	偉
传	傳
优	優
伤	傷
价	價
伦	倫
华	華
伙	夥
伙	伙
伪	僞
向	向
向	嚮
后	後
后	后
会	會
杀	殺
合	合
合	閤
爷	爺
伞	傘
创	創
杂	雜
负	負
壮	壯
冲	衝
冲	沖
妆	妝
庄	莊
庆	慶
刘	劉
齐	齊
产	產
闭	閉
问	問
闯	闖
关	關
灯	燈
汤	湯
兴	興
讲	講
讳	諱
军	軍
讶	訝
许	許
讹	訛
论	論
讼	訟
农	農
讽	諷
设	設
访	訪
诀	訣
寻	尋
尽	儘
尽	盡
导	導
孙	孫
阵	陣
阳	陽
阶	階
阴	陰
妇	婦
妈	媽
戏	戲
观	觀
欢	歡
买	買
红	紅
驮	馱
纤	縴
纤	纖
驯	馴
约	約
级	級
纪	紀
驰	馳
纫	紉
寿	壽
麦	麥
玛	瑪
进	進
远	遠
违	違
韧	韌
运	運
抚	撫
坛	壇
坛	罎
坏	壞
抠	摳
扰	擾
贡	貢
坝	垻
坝	壩
折	折
折	摺
抡	掄
抢	搶
坟	墳
护	護
壳	殼
块	塊
声	聲
报	報
拟	擬
芜	蕪
苇	葦
苍	蒼
严	嚴
芦	蘆
劳	勞
克	克
克	剋
苏	蘇
苏	囌
极	極
杨	楊
两	兩
丽	麗
医	醫
励	勵
还	還
歼	殲
来	來
连	連
轩	軒
卤	滷
卤	鹵
坚	堅
时	時
县	縣
里	里
里	裏
呕	嘔
园	園
旷	曠
围	圍
吨	噸
邮	郵
困	困
困	睏
员	員
听	聽
呛	嗆
呜	嗚
别	別
别	彆
岖	嶇
岗	崗
帐	帳
财	財
针	針
钉	釘
乱	亂
体	體
佣	傭
彻	徹
余	餘
余	余
谷	穀
谷	谷
邻	鄰
肠	腸
龟	龜
犹	猶
狈	狽
条	條
岛	島
饭	飯
饮	飲
系	係
系	系
系	繫
冻	凍
状	狀
亩	畝
库	庫
疗	療
应	應
这	這
庐	廬
闰	閏
间	間
闷	悶
灶	竈
灿	燦
沥	瀝
沦	淪
沧	滄
沟	溝
沪	滬
沈	沈
沈	瀋
怀	懷
忧	憂
穷	窮
证	證
启	啓
评	評
补	補
识	識
诈	詐
诉	訴
诊	診
词	詞
译	譯
灵	靈
层	層
迟	遲
张	張
际	際
陆	陸
陈	陳
坠	墜
劲	勁
鸡	雞
纬	緯
驱	驅
纯	純
纱	紗
纲	綱
纳	納
驳	駁
纵	縱
纷	紛
纸	紙
纹	紋
纺	紡
驴	驢
纽	紐
环	環
责	責
现	現
表	表
表	錶
规	規
拢	攏
拣	揀
担	擔
顶	頂
拥	擁
势	勢
拦	攔
拧	擰
拨	撥
择	擇
苹	蘋
范	范
范	範
茎	莖
枢	樞
柜	櫃
板	板
板	闆
松	松
松	鬆
枪	槍
枫	楓
构	構
丧	喪
画	畫
枣	棗
卖	賣
郁	郁
郁	鬱
矾	礬
矿	礦
码	碼
厕	厠
奋	奮
态	態
欧	歐
殴	毆
垄	壟
轰	轟
顷	頃
转	轉
斩	斬
轮	輪
软	軟
齿	齒
虏	虜
肾	腎
贤	賢
国	國
畅	暢
咙	嚨
鸣	鳴
罗	羅
帜	幟
岭	嶺
凯	凱
败	敗
账	賬
贩	販
贬	貶
购	購
贮	貯
图	圖
钓	釣
制	制
制	製
刮	刮
刮	颳
侠	俠
侥	僥
侦	偵
侧	側
凭	憑
侨	僑
货	貨
质	質
征	徵
征	征
径	徑
舍	舍
舍	捨
觅	覓
贪	貪
贫	貧
肤	膚
肿	腫
胀	脹
肮	骯
胁	脅
鱼	魚
狞	獰
备	備
饰	飾
饱	飽
饲	飼
变	變
庞	龐
庙	廟
疟	瘧
剂	劑
废	廢
闸	閘
闹	鬧
郑	鄭
卷	卷
卷	捲
单	單
炉	爐
浅	淺
泞	濘
泻	瀉
注	注 註
泼	潑
泽	澤
怜	憐
学	學
宝	寶
宠	寵
审	審
帘	簾
帘	帘
实	實
试	試
诗	詩
诚	誠
衬	襯
视	視
话	話
诞	誕
诡	詭
询	詢
该	該
详	詳
肃	肅
录	錄
隶	隸
弥	彌
弥	瀰
陕	陝
驾	駕
参	參
艰	艱
线	綫
练	練
组	組
绅	紳
细	細
驶	駛
织	織
驹	駒
终	終
驻	駐
绊	絆
驼	駝
绍	紹
绎	繹
经	經
贯	貫
贰	貳
帮	幫
项	項
挟	挾
挠	撓
赵	趙
挡	擋
垫	墊
挤	擠
挥	揮
荐	薦
带	帶
茧	繭
荡	蕩
荣	榮
荤	葷
荧	熒
胡	胡
胡	鬍
荫	蔭
药	藥
标	標
栈	棧
栋	棟
栏	欄
柠	檸
树	樹
咸	咸
咸	鹹
砖	磚
砚	硯
面	面
面	麵
牵	牽
鸥	鷗
残	殘
轴	軸
轻	輕
鸦	鴉
战	戰
点	點
临	臨
览	覽
竖	竪
尝	嘗
哑	啞
显	顯
贵	貴
虾	蝦
蚁	蟻
蚂	螞
虽	雖
骂	駡
勋	勛
哗	嘩
响	響
哟	喲
峡	峽
罚	罰
贱	賤
贴	貼
贻	貽
钙	鈣
钝	鈍
钞	鈔
钟	鍾
钟	鐘
钢	鋼
钠	鈉
钥	鑰
钦	欽
钧	鈞
钩	鈎
钮	鈕
毡	氈
氢	氫
选	選
适	適
种	种
种	種
秋	秋
秋	鞦
复	復
复	複
俩	倆
贷	貸
顺	順
俭	儉
须	須
须	鬚
剑	劍
胧	朧
胆	膽
胜	勝
狭	狹
狮	獅
独	獨
狱	獄
贸	貿
饵	餌
饶	饒
蚀	蝕
饺	餃
饼	餅
峦	巒
弯	彎
将	將
奖	獎
疮	瘡
疯	瘋
亲	親
闺	閨
闻	聞
闽	閩
阀	閥
阁	閣
养	養
姜	姜
姜	薑
类	類
娄	婁
总	總
炼	煉
烁	爍
烂	爛
洼	窪
洁	潔
洒	灑
浇	澆
浊	濁
测	測
浏	瀏
济	濟
浑	渾
浓	濃
恼	惱
举	舉
觉	覺
宪	憲
窃	竊
诫	誡
诬	誣
语	語
袄	襖
误	誤
诱	誘
诲	誨
说	說
诵	誦
垦	墾
昼	晝
费	費
逊	遜
陨	隕
险	險
娇	嬌
贺	賀
垒	壘
绑	綁
绒	絨
结	結
绕	繞
骄	驕
绘	繪
给	給
绚	絢
骆	駱
络	絡
绝	絕
绞	絞
骇	駭
统	統
艳	艷
蚕	蠶
顽	頑
盏	盞
捞	撈
载	載
赶	趕
盐	鹽
损	損
捡	撿
挚	摯
热	熱
捣	搗
壶	壺
聂	聶
莱	萊
莲	蓮
获	獲
获	穫
恶	惡
恶	噁
莹	瑩
莺	鶯
档	檔
桥	橋
桦	樺
桩	樁
样	樣
贾	賈
砾	礫
础	礎
顾	顧
轿	轎
较	較
顿	頓
毙	斃
致	致
致	緻
虑	慮
监	監
紧	緊
党	黨
党	党
晒	曬
晓	曉
唠	嘮
鸭	鴨
晕	暈
鸯	鴦
罢	罷
圆	圓
贼	賊
贿	賄
赂	賂
赃	贓
钱	錢
钳	鉗
钻	鑽
钾	鉀
铁	鐵
铃	鈴
铅	鉛
牺	犧
敌	敵
积	積
称	稱
笔	筆
债	債
借	借
借	藉
倾	傾
赁	賃
舰	艦
舱	艙
耸	聳
爱	愛
颁	頒
颂	頌
脏	臟
脏	髒
脐	臍
胶	膠
脑	腦
脓	膿
鸵	鴕
鸳	鴛
皱	皺
饿	餓
馁	餒
恋	戀
桨	槳
浆	漿
准	準
准	准
症	症
症	癥
斋	齋
离	離
资	資
竞	競
阅	閱
烦	煩
烧	燒
烛	燭
递	遞
涛	濤
涝	澇
涡	渦
涂	塗
涂	涂
涤	滌
润	潤
涧	澗
涨	漲
烫	燙
涩	澀
悯	憫
宽	寬
家	家
家	傢
宾	賓
窍	竅
请	請
诸	諸
诺	諾
读	讀
诽	誹
袜	襪
课	課
谁	誰
调	調
谅	諒
谆	諄
谈	談
谊	誼
恳	懇
剧	劇
难	難
预	預
绢	絹
绣	綉
验	驗
继	繼
骏	駿
琐	瑣
掷	擲
据	據
据	据
掺	摻
职	職
萝	蘿
萤	螢
营	營
萧	蕭
萨	薩
梦	夢
检	檢
酝	醞
硕	碩
聋	聾
袭	襲
辅	輔
辆	輛
颅	顱
悬	懸
跃	躍
累	纍
累	累
啰	囉
啸	嘯
崭	嶄
逻	邏
婴	嬰
铐	銬
铛	鐺
铝	鋁
铜	銅
铭	銘
铲	鏟
银	銀
矫	矯
秽	穢
笼	籠
偿	償
躯	軀
衅	釁
衔	銜
盘	盤
鸽	鴿
敛	斂
领	領
脸	臉
猎	獵
馅	餡
馆	館
痒	癢
旋	旋
旋	鏇
阎	閻
阐	闡
盖	蓋
断	斷
兽	獸
鸿	鴻
渐	漸
渊	淵
渔	漁
淀	淀
淀	澱
渗	滲
惭	慚
惧	懼
惊	驚
惨	慘
惯	慣
谋	謀
谍	諜
谎	謊
谐	諧
祷	禱
祸	禍
谓	謂
谚	諺
谜	謎
弹	彈
堕	墮
随	隨
隐	隱
婶	嬸
颇	頗
颈	頸
绩	績
绪	緒
续	續
骑	騎
绰	綽
绳	繩
维	維
绵	綿
绷	綳
绸	綢
综	綜
绽	綻
绿	緑
缀	綴
琼	瓊
趋	趨
揽	攬
搀	攙
搁	擱
搂	摟
搅	攪
联	聯
蒋	蔣
韩	韓
椭	橢
确	確
颊	頰
雳	靂
暂	暫
翘	翹
辈	輩
凿	鑿
辉	輝
赏	賞
睐	睞
喷	噴
畴	疇
践	踐
遗	遺
鹃	鵑
赋	賦
赌	賭
赎	贖
赐	賜
赔	賠
铸	鑄
铺	鋪
链	鏈
销	銷
锁	鎖
锄	鋤
锅	鍋
锈	銹
锋	鋒
锌	鋅
锐	銳
鹅	鵝
筑	筑
筑	築
筛	篩
储	儲
惩	懲
御	御
御	禦
释	釋
鲁	魯
惫	憊
馈	饋
馋	饞
装	裝
蛮	蠻
阔	闊
粪	糞
滞	滯
湿	濕
溃	潰
溅	濺
湾	灣
愤	憤
窜	竄
窝	窩
裤	褲
禅	禪
禄	祿
谢	謝
谣	謠
谤	謗
谦	謙
属	屬
屡	屢
缅	緬
缆	纜
缉	緝
缎	緞
缓	緩
缔	締
缕	縷
骗	騙
编	編
骚	騷
缘	緣
鹉	鵡
摄	攝
摆	擺
摆	襬
摊	攤
鹊	鵲
蓝	藍
蒙	濛
蒙	矇
蒙	懞
蒙	蒙
献	獻
榄	欖
楼	樓
赖	賴
碍	礙
尴	尷
雾	霧
辐	輻
辑	輯
输	輸
频	頻
龄	齡
鉴	鑒
跷	蹺
蜗	蝸
错	錯
锚	錨
锡	錫
锣	鑼
锤	錘
锥	錐
锦	錦
键	鍵
锯	鋸
锰	錳
辞	辭
颓	頹
筹	籌
签	簽
签	籤
简	簡
腻	膩
鹏	鵬
腾	騰
鲍	鮑
颖	穎
触	觸
雏	雛
馍	饃
馏	餾
酱	醬
誊	謄
粮	糧
数	數
满	滿
滤	濾
滥	濫
漓	漓
漓	灕
滨	濱
滩	灘
誉	譽
窥	窺
寝	寢
谨	謹
谬	謬
辟	闢
辟	辟
缚	縛
缝	縫
缠	纏
缤	繽
赘	贅
墙	墻
蔑	蔑
蔑	衊
蔼	藹
槛	檻
酿	釀
愿	願
辖	轄
辗	輾
颗	顆
踊	踊
蜡	蠟
蝇	蠅
蝉	蟬
赚	賺
锹	鍬
锻	鍛
镀	鍍
稳	穩
箩	籮
箫	簫
舆	輿
鲜	鮮
馒	饅
潇	瀟
赛	賽
谭	譚
谱	譜
骡	騾
缩	縮
撵	攆
聪	聰
蕴	蘊
樱	櫻
飘	飄
霉	黴
瞒	瞞
题	題
嘱	囑
镇	鎮
镐	鎬
镑	鎊
篓	簍
鲤	鯉
鲫	鯽
瘪	癟
瘫	癱
颜	顏
鲨	鯊
澜	瀾
额	額
谴	譴
鹤	鶴
缭	繚
颠	顛
辙	轍
鹦	鸚
赠	贈
镜	鏡
赞	贊
篮	籃
篱	篱
篱	籬
鲸	鯨
瘾	癮
辩	辯
濒	瀕
懒	懶
缰	繮
缴	繳
瞩	矚
赡	贍
鳄	鰐
辫	辮
赢	贏
骤	驟
嚣	囂
镰	鐮
鳍	鰭
鹰	鷹
巅	巔
颤	顫
癣	癬
鳖	鱉
鬓	鬢
鳞	鱗
躏	躪
赣	贛
镶	鑲
韦	韋
闩	閂
讣	訃
劢	勱
刍	芻
邝	鄺
讦	訐
讧	訌
讪	訕
讫	訖
驭	馭
玑	璣
圹	壙
扪	捫
芗	薌
厍	厙
钇	釔
伛	傴
伥	倀
伧	傖
伫	佇
犷	獷
犸	獁
凫	鳧
邬	鄔
饧	餳
忏	懺
讴	謳
讵	詎
讷	訥
纡	紆
纣	紂
纥	紇
纨	紈
玙	璵
抟	摶
坞	塢
㧐	㩳
芸	芸
芸	蕓
苈	藶
苋	莧
苌	萇
苁	蓯
苎	苧
矶	磯
奁	奩
欤	歟
轫	軔
邺	鄴
呒	嘸
呓	囈
呖	嚦
旸	暘
呗	唄
帏	幃
岘	峴
岚	嵐
囵	圇
钊	釗
钋	釙
钌	釕
佥	僉
奂	奐
鸠	鳩
邹	鄒
饨	飩
饩	餼
饪	飪
饫	飫
饬	飭
庑	廡
疖	癤
闱	闈
闳	閎
闵	閔
炀	煬
沣	灃
沤	漚
沨	渢
沩	潙
怃	憮
怄	慪
忾	愾
怅	悵
怆	愴
诂	詁
诃	訶
诅	詛
诋	詆
诌	謅
诏	詔
诒	詒
陇	隴
陉	陘
妩	嫵
妪	嫗
妫	嬀
刭	剄
纭	紜
纰	紕
纴	紝
纶	綸
纾	紓
玮	瑋
匦	匭
垆	壚
㧟	擓
茏	蘢
茑	蔦
茔	塋
茕	煢
枥	櫪
枧	梘
枨	棖
枞	樅
砀	碭
瓯	甌
郏	郟
轭	軛
鸢	鳶
昙	曇
虮	蟣
黾	黽
咛	嚀
咝	噝
岿	巋
刿	劌
剀	剴
峄	嶧
钍	釷
钎	釺
钏	釧
钒	釩
钕	釹
钗	釵
侩	儈
侪	儕
侬	儂
刽	劊
怂	慫
籴	糴
戗	戧
䏝	膞
迩	邇
枭	梟
饯	餞
饴	飴
疠	癘
疡	瘍
炜	煒
𬉼	熰
炝	熗
泷	瀧
泸	瀘
泺	濼
泾	涇
㤘	㥮
怿	懌
诓	誆
诔	誄
诖	詿
诘	詰
诙	詼
郓	鄆
祎	禕
诛	誅
诜	詵
诟	詬
诠	詮
诣	詣
诤	諍
诧	詫
诨	諢
诩	詡
驽	駑
绀	紺
绁	紲
绂	紱
驷	駟
驸	駙
绉	縐
绌	絀
驿	驛
骀	駘
珑	瓏
顸	頇
垭	埡
挝	撾
挞	撻
贲	賁
垱	壋
挦	撏
荚	莢
贳	貰
荜	蓽
荞	蕎
荟	薈
荠	薺
垩	堊
荥	滎
荦	犖
荨	蕁
荩	藎
荪	蓀
荬	蕒
荮	葤
栉	櫛
栊	櫳
栌	櫨
栎	櫟
柽	檉
郦	酈
砗	硨
砜	碸
殇	殤
轱	軲
轲	軻
轳	轤
轶	軼
轸	軫
虿	蠆
觇	覘
眍	瞘
哓	嘵
哔	嗶
哕	噦
剐	剮
郧	鄖
哙	噲
哝	噥
峣	嶢
帧	幀
峤	嶠
贶	貺
钚	鈈
钛	鈦
钡	鋇
钣	鈑
钤	鈐
钨	鎢
钫	鈁
钯	鈀
笃	篤
俦	儔
俨	儼
俪	儷
胨	腖
胪	臚
胫	脛
鸨	鴇
狯	獪
飑	颮
狲	猻
饷	餉
饸	餄
饹	餎
孪	孿
娈	孌
疬	癧
疭	瘲
飒	颯
闼	闥
闾	閭
闿	闓
阂	閡
炽	熾
烃	烴
浃	浹
浍	澮
浒	滸
浔	洵
浕	濜
恸	慟
恹	懨
恺	愷
恻	惻
恽	惲
诮	誚
祢	禰
诰	誥
诳	誑
鸩	鴆
娅	婭
娆	嬈
怼	懟
绔	絝
骁	驍
骅	驊
绗	絎
绛	絳
骈	駢
顼	頊
珰	璫
珲	琿
埘	塒
埙	塤
埚	堝
贽	贄
莳	蒔
莴	萵
莸	蕕
鸪	鴣
莼	蒓
桡	橈
桢	楨
桤	榿
桧	檜
逦	邐
砺	礪
砻	礱
轼	軾
轾	輊
辂	輅
鸫	鶇
趸	躉
龀	齔
鸬	鸕
眬	矓
唛	嘜
鸮	鴞
蚬	蜆
唢	嗩
崂	嶗
崃	崍
觊	覬
赅	賅
钰	鈺
钲	鉦
钴	鈷
钵	鉢
钹	鈸
钺	鉞
钽	鉭
钼	鉬
钿	鈿
铀	鈾
铂	鉑
铄	鑠
铆	鉚
铈	鈰
铉	鉉
铊	鉈
铋	鉍
铌	鈮
铍	鈹
䥽	鏺
铎	鐸
氩	氬
笕	筧
颀	頎
徕	徠
脍	膾
鸱	鴟
玺	璽
鸲	鴝
猃	獫
袅	裊
饽	餑
栾	欒
挛	攣
痈	癰
痉	痙
颃	頏
阃	閫
阄	鬮
訚	誾
阆	閬
郸	鄲
烨	燁
烩	燴
烬	燼
涞	淶
涟	漣
涠	潿
悭	慳
诹	諏
诼	諑
祯	禎
诿	諉
谀	諛
谂	諗
谄	諂
谇	誶
娲	媧
娴	嫻
绠	綆
骊	驪
绡	綃
骋	騁
绥	綏
绦	絛
绨	綈
骎	駸
鸶	鷥
焘	燾
琏	璉
麸	麩
掳	擄
掴	摑
鸷	鷙
掸	撣
悫	慤
掼	摜
萦	縈
梿	槤
觋	覡
棂	欞
啬	嗇
匮	匱
硖	硤
硗	磽
鸸	鴯
龚	龔
殒	殞
殓	殮
赉	賚
辄	輒
堑	塹
啧	嘖
啭	囀
啮	嚙
跄	蹌
蛎	蠣
蛊	蠱
蛏	蟶
帻	幘
帼	幗
赇	賕
赈	賑
赊	賒
铑	銠
铒	鉺
铗	鋏
铙	鐃
铟	銦
铠	鎧
铡	鍘
铢	銖
铣	銑
铤	鋌
铧	鏵
铨	銓
铩	鎩
铪	鉿
铫	銚
铬	鉻
铮	錚
铯	銫
铰	鉸
铱	銥
铳	銃
铵	銨
铷	銣
鸹	鴰
秾	穠
笺	箋
笾	籩
偾	僨
偻	僂
皑	皚
鸻	鴴
舻	艫
龛	龕
猡	玀
猕	獼
馃	餜
馄	餛
鸾	鸞
阇	闍
阈	閾
阉	閹
阊	閶
阋	鬩
阍	閽
阏	閼
羟	羥
粝	糲
焖	燜
渍	漬
渎	瀆
渑	澠
惬	愜
惮	憚
谌	諶
谏	諫
皲	皸
谑	謔
裆	襠
谒	謁
谔	諤
谕	諭
谖	諼
谗	讒
谙	諳
谛	諦
谝	諞
粜	糶
婵	嬋
绫	綾
骐	騏
绮	綺
绯	緋
绱	緔
骒	騍
绲	緄
骓	騅
绶	綬
绺	綹
绻	綣
绾	綰
骖	驂
缁	緇
靓	靚
辇	輦
鼋	黿
颉	頡
揿	撳
蛰	蟄
塆	壪
蒌	蔞
椟	櫝
椤	欏
赍	賫
鹁	鵓
鹂	鸝
殚	殫
辊	輥
辋	輞
椠	槧
辍	輟
辎	輜
睑	瞼
跞	躒
蛱	蛺
蛲	蟯
蛳	螄
蛴	蠐
喽	嘍
嵘	嶸
嵝	嶁
赕	賧
铻	鋙
铼	錸
铿	鏗
锃	鋥
锂	鋰
锆	鋯
锇	鋨
锉	銼
锏	鐧
锑	銻
锒	鋃
锔	鋦
锕	錒
犊	犢
鹄	鵠
筚	篳
牍	牘
傥	儻
傧	儐
傩	儺
媭	嬃
颌	頜
鹆	鵒
鱿	魷
鲀	魨
鲂	魴
颍	潁
飓	颶
觞	觴
颎	熲
馇	餷
馊	餿
亵	褻
脔	臠
痨	癆
痫	癇
赓	賡
颏	頦
鹇	鷳
阑	闌
阒	闃
阕	闋
鹈	鵜
溆	漵
愦	憒
喾	嚳
谟	謨
裢	褳
裥	襇
谠	讜
谡	謖
谥	謚
谧	謐
骘	騭
巯	巰
翚	翬
骛	騖
缂	緙
缃	緗
缄	緘
缇	緹
缈	緲
缌	緦
缑	緱
缒	縋
缗	緡
飨	饗
耢	耮
骜	驁
韫	韞
摅	攄
摈	擯
毂	轂
蓦	驀
鹋	鶓
蓟	薊
蓠	蘺
蓥	鎣
颐	頤
榈	櫚
榉	櫸
碛	磧
碜	磣
鹌	鵪
辏	輳
龃	齟
龅	齙
韪	韙
嗫	囁
跶	躂
跸	蹕
跹	躚
跻	躋
嗳	噯
锗	鍺
锛	錛
锜	錡
锝	鍀
锞	錁
锟	錕
锢	錮
锨	鍁
锩	錈
锭	錠
锱	錙
觎	覦
颔	頷
鲅	鮁
鲆	鮃
鲇	鮎
鲈	鱸
稣	穌
鲋	鮒
鲐	鮐
鹐	鵮
飕	颼
馐	饈
鹑	鶉
瘆	瘮
阖	闔
阗	闐
阙	闕
滟	灧
滢	瀅
滗	潷
滦	灤
滪	澦
慑	懾
鲎	鱟
骞	騫
窦	竇
谩	謾
谪	謫
嫒	嬡
嫔	嬪
缙	縉
缜	縝
缛	縟
辔	轡
骝	騮
缟	縞
缡	縭
缢	縊
缣	縑
骟	騸
觏	覯
韬	韜
叆	靉
撄	攖
蔷	薔
蔺	藺
鹕	鶘
槟	檳
槠	櫧
酽	釅
殡	殯
霁	霽
辕	轅
龇	齜
龈	齦
䁖	瞜
暧	曖
踌	躊
蝈	蟈
鹗	鶚
嘤	嚶
罴	羆
赙	賻
罂	罌
鹘	鶻
锲	鍥
锴	鍇
锶	鍶
锷	鍔
锸	鍤
锵	鏘
镁	鎂
镂	鏤
箦	簀
箧	篋
箪	簞
箓	籙
膑	臏
鲑	鮭
鲔	鮪
鲚	鱭
鲛	鮫
鲟	鱘
馑	饉
銮	鑾
瘘	瘻
阚	闞
鲞	鯗
糁	糝
鹚	鷀
潋	瀲
潍	濰
谮	譖
褛	褸
谯	譙
谰	讕
谲	譎
鹛	鶥
嫱	嬙
鹜	鶩
骠	驃
缥	縹
缦	縵
缧	縲
缨	纓
骢	驄
缪	繆
缫	繅
耧	耬
璎	瓔
撷	擷
撸	擼
撺	攛
聩	聵
觐	覲
鞑	韃
鞒	鞽
蕲	蘄
赜	賾
樯	檣
靥	靨
魇	魘
餍	饜
辘	轆
龉	齬
龊	齪
觑	覷
颙	顒
踬	躓
踯	躑
蝾	蠑
蝼	螻
颚	顎
噜	嚕
颛	顓
镊	鑷
镉	鎘
镌	鐫
镍	鎳
镏	鎦
镒	鎰
镓	鎵
镔	鑌
篑	簣
鹞	鷂
鲠	鯁
鲡	鱺
鲢	鰱
鲣	鰹
鲥	鰣
鲧	鯀
鲩	鯇
觯	觶
馓	饊
馔	饌
齑	齏
谳	讞
褴	襤
谵	譫
屦	屨
缬	纈
缮	繕
缯	繒
骣	驏
擞	擻
颞	顳
颟	顢
薮	藪
橹	櫓
橼	櫞
赝	贋
飙	飆
錾	鏨
辚	轔
螨	蟎
䦃	鐯
镖	鏢
镗	鏜
镘	鏝
镚	鏰
镛	鏞
镝	鏑
镞	鏃
镠	鏐
氇	氌
穑	穡
魉	魎
鲮	鯪
鲱	鯡
鲲	鯤
鲳	鯧
鲴	鯝
鲵	鯢
鲷	鯛
鲻	鯔
獭	獺
鹧	鷓
赟	贇
瘿	癭
斓	斕
濑	瀨
颡	顙
缱	繾
缲	繰
缳	繯
藓	蘚
鹩	鷯
龋	齲
龌	齷
蹑	躡
蹒	蹣
羁	羈
镡	鐔
镢	鐝
镣	鐐
镦	鐓
镧	鑭
镩	鑹
镪	鏹
镫	鐙
簖	籪
鹪	鷦
鲼	鱝
鲽	鰈
鳀	鯷
鳃	鰓
鳅	鰍
鳇	鰉
鳊	鯿
鹫	鷲
懑	懣
鹬	鷸
鳌	鰲
鞯	韉
颢	顥
鹭	鷺
鹮	䴉
髅	髏
镬	鑊
镭	鐳
镯	鐲
雠	讎
鳎	鰨
鳏	鰥
鳐	鰩
癞	癩
攒	攢
霭	靄
蹿	躥
髋	髖
髌	髕
镲	鑔
籁	籟
鳓	鰳
鳔	鰾
鳕	鱈
鳗	鰻
鳙	鱅
谶	讖
骥	驥
缵	纘
瓒	瓚
鼍	鼉
黩	黷
黪	黲
镳	鑣
镴	鑞
臜	臢
鳜	鱖
鳝	鱔
鳟	鱒
骧	驤
颦	顰
鳢	鱧
癫	癲
灏	灝
鹳	鸛
镵	鑱
趱	趲
颧	顴
躜	躦
馕	饢
戆	戇
戋	戔
𬣙	訏
讱	訒
钆	釓
伣	俔
闫	閆
𬇕	澫
䜣	訢
讻	訩
𬣞	詝
𬘓	紃
纩	纊
玚	瑒
刬	剗
𫭟	塸
坜	壢
𫭢	埨
㧑	撝
𫇭	蔿
杩	榪
轪	軑
𫐄	軏
呙	咼
𫵷	㠣
觃	覎
㑇	㑳
飏	颺
闶	閌
𣲘	潕
𣲗	湋
沄	澐
𬇙	浿
𬣡	諓
祃	禡
诇	詗
诎	詘
诐	詖
屃	屓
𫸩	彄
纮	紘
驲	馹
𫘜	馼
纻	紵
𬘘	紞
𫘝	駃
纼	紖
玱	瑲
苧	薴
㭎	棡
𬨂	軝
𬀩	暐
𬀪	晛
岽	崬
𬬩	釴
钐	釤
钔	鍆
钖	鍚
郐	鄶
狝	獮
饳	飿
峃	嶨
𫍣	詷
𬣳	詪
𬩽	鄩
鸤	鳲
𬮿	隑
𬯀	隮
𫰛	娙
迳	逕
𬳵	駓
驵	駔
𬳶	駉
䌹	絅
驺	騶
𫠊	䮄
绋	紼
绐	紿
𬍛	瓅
韨	韍
垯	墶
垲	塏
荙	薘
荛	蕘
𬜬	蔄
荭	葒
䴓	鳾
䶮	龑
轵	軹
轷	軤
轹	轢
轺	軺
𪾢	睍
昽	曨
哒	噠
钘	鈃
𫓧	鈇
钜	鉅
𬬮	鋹
𬬱	釿
𬬭	錀
钪	鈧
钬	鈥
钭	鈄
俫	倈
舣	艤
鸧	鶬
飐	颭
饻	餏
浈	湞
浉	溮
浐	滻
袆	褘
绖	絰
骃	駰
𬘡	絪
𬳽	駪
𬘩	綎
𫄧	綖
骉	驫
𪟝	勣
𬍤	璕
𫭼	𡑍
𬜯	䓣
莶	薟
䓖	藭
桠	椏
𬂩	梜
𫠆	頍
硁	硜
𨐈	輄
辀	輈
辁	輇
赀	貲
唝	嗊
晔	曄
晖	暉
𫑡	鄳
帱	幬
𪨶	輋
崄	嶮
赆	贐
𬬸	鉥
钷	鉕
𬬻	鑪
𬬹	鉮
𬬿	鉊
𬭁	鉧
𫢸	僤
鸰	鴒
鱽	魛
𫗧	餗
𬊈	燖
涢	溳
𬒈	礐
窎	窵
袯	襏
𬳿	駼
𫄨	絺
绤	綌
骍	騂
𬘫	綄
琎	璡
𫮃	墠
壸	壼
聍	聹
萚	蘀
勚	勩
䓨	罃
梼	檮
梾	棶
厣	厴
鿎	䃮
硙	磑
硚	礄
䴕	鴷
龁	齕
𬱖	頔
𬟽	蝀
啴	嘽
铏	鉶
𫓯	銈
𫟹	鉷
铕	銪
𫟼	鐽
铖	鋮
铘	鋣
铚	銍
铞	銱
铥	銩
铴	鐋
鸺	鵂
鸼	鵃
䝙	貙
脶	腡
鱾	魢
庼	廎
䴔	鵁
阌	閿
𬇹	漍
𬍡	璗
𬤇	諲
𫍯	諴
裈	褌
𬤊	諟
𫍲	謏
谞	諝
𬯎	隤
婳	嫿
𬘬	綪
𬘭	綝
𬴂	騑
𫘦	騊
绹	綯
𫟅	綡
𬘯	綧
骕	驌
𫘧	騄
絷	縶
𪣻	塿
蒇	蕆
蒉	蕢
𬃊	櫍
鹀	鵐
𬷕	鵏
酦	醱
觌	覿
詟	讋
𫐐	輗
辌	輬
龂	齗
𬹼	齘
𫶇	嵽
嵚	嶔
翙	翽
𫖮	顗
赑	贔
赒	賙
鿏	䥑
铹	鐒
𬭊	𨧀
铽	鋱
𨱇	銶
𫓶	鋗
锊	鋝
锍	鋶
锎	鐦
𬭎	鋐
锓	鋟
颋	頲
筜	簹
𫖯	頫
腘	膕
𬱟	頠
鲃	䰾
𫛭	鵟
馉	餶
𫷷	廞
𬮱	闉
𬊤	燀
𣸣	濆
溁	濚
溇	漊
敩	斆
裣	襝
毵	毿
𬴃	騞
𫘨	騠
缊	縕
缐	線
骙	騤
䴖	鶄
赪	赬
蓣	蕷
榇	櫬
𬪩	醲
䃅	磾
辒	轀
𬨎	輶
𫐓	輮
龆	齠
鹍	鵾
𫫇	噁
赗	賵
锖	錆
𫓹	錤
锘	鍩
锳	鍈
锧	鑕
锪	鍃
𬭚	錞
锫	錇
锬	錟
𬭛	𨨏
䅟	穇
𬕂	篢
筼	篔
鹎	鵯
鲉	鮋
鲊	鮓
鲌	鮊
䲟	鮣
𬶋	鮈
𬶍	鮀
鲏	鮍
飔	颸
𦝼	膢
馌	饁
瘅	癉
鹒	鶊
阘	闒
𫔶	闑
滠	灄
𫌀	襀
谫	譾
鹔	鷫
𫖳	頵
𫘪	騵
𫘬	騱
缞	縗
𫞩	璊
瑷	璦
蔹	蘞
槚	檟
𣗋	欓
𬸘	鶠
酾	釃
𬒗	𥗽
𫚖	鮆
䴗	鶪
鹖	鶡
𨱏	鎝
锺	鍾
锼	鎪
锽	鍠
𬭤	鍭
锾	鍰
锿	鎄
镃	鎡
镄	鐨
镅	鎇
鹙	鶖
箨	籜
鲒	鮚
鲕	鮞
𫚕	鰤
鲖	鮦
鲗	鰂
鲘	鮜
鲙	鱠
𬶐	鮡
𬶏	鮠
𩽾	鮟
飗	飀
𬸚	鸑
瘗	瘞
鲝	鮺
潆	瀠
窭	窶
𬤝	譓
𬙂	縯
麹	麴
叇	靆
鹝	鷊
慭	憖
䗖	螮
镆	鏌
镈	鎛
镋	钂
镎	鎿
𬭩	鎓
镕	鎔
䴘	鷉
鹟	鶲
𩾃	鮸
鲦	鰷
鲪	鮶
鲬	鯒
鹠	鶹
鹡	鶺
鹢	鷁
鹣	鶼
澛	瀂
𬸣	鶱
𫍽	譞
𬴊	驎
𬞟	蘋
豮	豶
𫟦	䡵
𬺈	齮
𫠜	齯
鹾	鹺
𪩘	巘
𬭬	鏏
𨱑	鐄
𬭯	䥕
篯	籛
鲭	鯖
鲯	鯕
鲰	鯫
鲺	鯴
鲹	鰺
𫗴	饘
亸	嚲
𬸦	鷟
黉	黌
鹨	鷚
𫄷	繶
𤩽	瓛
蟏	蠨
㘎	㘚
𬭳	𨭎
镤	鏷
𬭶	𨭆
𫔍	鐇
镥	鑥
镨	鐠
𬭸	鏻
𨱔	鐏
𬭼	鐩
𫔎	鐍
𬸪	鷭
䲠	鰆
𬶟	鯻
鲾	鰏
𬶠	鰊
鲿	鱨
鳁	鰛
鳂	鰃
鳈	鰁
鳉	鱂
襕	襴
𬶨	鱀
𦈡	繻
𫄸	纁
鬶	鬹
𬟁	虉
鹲	鸏
黡	黶
镮	鐶
镱	鐿
酂	酇
䲢	鰧
鳑	鰟
鳒	鰜
鹱	鸌
鹯	鸇
冁	囅
䴙	鸊
𬙊	纆
鳘	鰵
𬶭	鰶
𩾌	鱇
鳚	䲁
鳛	鰼
彟	彠
颥	顬
𬶮	鱚
骦	驦
𬙋	纕
𬺓	齼
鳠	鱯
鳡	鱤
鳣	鱣
鹴	鸘
鳤	䲘
𫚭	鱲
㐷	傌
㐹	㑶
㐹	㐹
㐽	偑
㑈	倲
㑔	㑯
㑩	儸
㓆	𠗣
㓥	劏
㓰	劃
㔉	劚
㖊	噚
㖞	喎
㚯	㜄
㛀	媰
㛟	𡞵
㛠	𡢃
㛣	㜏
㛤	孋
㛿	𡠹
㟆	㠏
㟜	𡾱
㟥	嵾
㡎	幓
㤽	懤
㥪	慺
㧏	掆
㧰	擽
㨫	㩜
㭏	椲
㭣	𣙎
㭤	樢
㭴	樫
㱩	殰
㱮	殨
㲿	瀇
㳔	濧
㳕	灡
㳠	澾
㳡	濄
㳢	𣾷
㳽	瀰
㴋	潚
㶉	鸂
㶶	燶
㶽	煱
㺍	獱
㻅	璯
㻏	𤫩
㻘	𤪺
䀥	䁻
䂵	碽
䅉	稏
䅪	𥢢
䇲	筴
䉤	籔
䌶	䊷
䌷	紬
䌸	縳
䌺	䋙
䌻	䋚
䌼	綐
䌽	綵
䌾	䋻
䌿	䋹
䍀	繿
䍁	繸
䍠	䍦
䎬	䎱
䑽	𦪙
䓓	薵
䓕	薳
䘛	𧝞
䘞	𧜗
䙊	𧜵
䙌	䙡
䙓	襬
䜤	鿁
䜥	𧩙
䜧	䜀
䜩	讌
䞌	𧵳
䞍	䝼
䞎	𧶧
䞐	賰
䟢	躎
䢀	𨊰
䢁	𨊸
䢂	𨋢
䥺	釾
䥾	䥱
䥿	𨯅
䦀	𨦫
䦁	𨧜
䦂	䥇
䦅	鐥
䦆	钁
䦶	䦛
䦷	䦟
䩄	靦
䭪	𩞯
䯃	𩣑
䯄	騧
䯅	䯀
䲝	䱽
䲞	𩶘
䲡	鰌
䲣	䱷
伡	俥
侭	儘
傤	儎
刾	㓨
厐	龎
哜	嚌
唡	啢
啯	嘓
垅	壠
弪	弳
彨	彲
悮	悞
戯	戱
挜	掗
挢	撟
捝	挩
揾	搵
搄	揯
擜	㩵
敚	敓
桪	樳
椝	槼
椢	槶
椫	樿
椮	槮
榝	樧
毶	𣯶
泶	澩
涚	涗
渖	瀋
瑸	璸
痖	瘂
瞆	瞶
硵	磠
硷	礆
穞	穭
筿	篠
緼	縕
縆	緪
纟	糹
绬	緓
缋	繢
缍	綞
缏	緶
荝	萴
蒀	蒕
蒏	醟
蔂	虆
藴	蘊
蚃	蠁
螀	螿
觍	覥
讠	訁
讬	託
诪	譸
诶	誒
谉	讅
谘	諮
贠	貟
輼	轀
醖	醞
钅	釒
钑	鈒
钶	鈳
钸	鈽
铇	鉋
铓	鋩
铔	錏
铦	銛
锠	錩
镙	鏍
镟	鏇
闬	閈
阓	闠
阛	闤
陦	隯
霡	霢
靔	靝
颒	頮
颕	頴
颣	纇
飖	颻
飚	飈
饣	飠
饤	飣
饦	飥
饾	餖
馀	餘
馂	餕
馎	餺
骔	騌
鲄	魺
鲓	鮳
鲶	鯰
鳆	鰒
鳋	鰠
鸴	鷽
鹓	鵷
鹥	鷖
麺	麪
鼌	鼂
鿒	鿓
鿔	鎶
𠀾	𠁞
𠆲	儣
𠆿	𠌥
𠇹	俓
𠉂	㒓
𠉗	𠏢
𠋆	儭
𠚳	𠠎
𠛅	剾
𠛆	𠞆
𠛾	𪟖
𠡠	勑
𠮶	嗰
𠯟	哯
𠯠	噅
𠰱	㘉
𠰷	嚧
𠱞	囃
𠲥	𡅏
𠴛	𡃕
𠴢	𡄔
𠵸	𡄣
𠵾	㗲
𡋀	𡓾
𡋗	𡑭
𡋤	壗
𡍣	𡔖
𡒄	壈
𡝠	㜷
𡞋	㜗
𡞱	㜢
𡠟	孎
𡥧	孻
𡭜	𡮉
𡭬	𡮣
𡳃	𡳳
𡳒	𦘧
𡶴	嵼
𡸃	𡽗
𡺃	嶈
𡺄	嶘
𢋈	㢝
𢗓	㦛
𢘙	𢤱
𢘝	𢣚
𢘞	𢣭
𢙏	愻
𢙐	憹
𢙑	𢠼
𢙒	憢
𢙓	懀
𢛯	㦎
𢠁	懎
𢢐	𤢻
𢧐	戰
𢫊	𢷮
𢫞	𢶫
𢫬	摋
𢬍	擫
𢬦	𢹿
𢭏	擣
𢽾	斅
𣃁	斸
𣆐	曥
𣈣	𣋋
𣍨	𦢈
𣍯	腪
𣍰	脥
𣎑	臗
𣏢	槫
𣐕	桱
𣐤	欍
𣑶	𣠲
𣒌	楇
𣓿	橯
𣔌	樤
𣗊	樠
𣗙	㰙
𣘐	㯤
𣘓	𣞻
𣘴	檭
𣘷	𣝕
𣚚	欘
𣞎	𣠩
𣨼	殢
𣭤	𣯴
𣯣	𣯩
𣱝	氭
𣳆	㵗
𣶩	澅
𣶫	𣿉
𣶭	𪷓
𣷷	𤅶
𣺼	灙
𣺽	𤁣
𣽷	瀃
𤆡	熓
𤆢	㷍
𤇃	爄
𤇄	熌
𤇭	爖
𤇹	熚
𤈶	熉
𤈷	㷿
𤊀	𤒎
𤊰	𤓩
𤋏	熡
𤎺	𤓎
𤎻	𤑳
𤙯	𤛮
𤝢	𤢟
𤞃	獩
𤞤	玁
𤠋	㺏
𤦀	瓕
𤳄	𤳸
𤶊	癐
𤶧	𤸫
𤻊	㿗
𤽯	㿧
𤾀	皟
𤿲	麬
𥁢	䀉
𥅘	𥌃
𥅴	䀹
𥅿	𥊝
𥆧	瞤
𥇢	䁪
𥎝	䂎
𥐟	礒
𥐯	𥖅
𥐰	𥕥
𥐻	碙
𥞦	𥞵
𥧂	𥨐
𥩟	竚
𥩺	𥪂
𥫣	籅
𥬀	䉙
𥬞	籋
𥬠	篘
𥭉	𥵊
𥮋	𥸠
𥮜	䉲
𥮾	篸
𥱔	𥵃
𥹥	𥼽
𥺅	䊭
𥺇	𥽖
𦈈	𥿊
𦈉	緷
𦈋	綇
𦈌	綀
𦈎	繟
𦈏	緍
𦈐	縺
𦈑	緸
𦈒	𦂅
𦈓	䋿
𦈔	縎
𦈕	緰
𦈖	䌈
𦈗	𦃄
𦈘	䌋
𦈙	䌰
𦈚	縬
𦈛	繓
𦈜	䌖
𦈝	繏
𦈞	䌟
𦈟	䌝
𦈠	䌥
𦍠	䍽
𦛨	朥
𦟗	𦣎
𦨩	𦪽
𦰏	蓧
𦰴	䕳
𦶟	爇
𦶻	𦾟
𦻕	蘟
𧉐	𧕟
𧉞	䗿
𧌥	𧎈
𧏖	蠙
𧏗	蠀
𧑏	蠾
𧒭	𧔥
𧜭	䙱
𧝝	襰
𧝧	𧟀
𧮪	詀
𧳕	𧳟
𧹑	䞈
𧹒	買
𧹓	𧶔
𧹔	賬
𧹕	䝻
𧹖	賟
𧹗	贃
𧿈	𨇁
𨀁	躘
𨀱	𨄣
𨁴	𨅍
𨂺	𨈊
𨄄	𨈌
𨅛	䠱
𨅫	𨇞
𨅬	躝
𨉗	軉
𨐅	軗
𨐆	𨊻
𨐇	𨏠
𨐉	𨎮
𨐊	𨏥
𨑹	䢨
𨟳	𨣞
𨠨	𨣧
𨡙	𨢿
𨡺	𨣈
𨤰	𨤻
𨰾	鎷
𨰿	釳
𨱀	𨥛
𨱁	鈠
𨱂	鈋
𨱃	鈲
𨱄	鈯
𨱅	鉁
𨱆	龯
𨱈	鋉
𨱉	鍄
𨱊	𨧱
𨱋	錂
𨱌	鏆
𨱍	鎯
𨱎	鍮
𨱐	𨫒
𨱒	鏉
𨱓	鐎
𨱕	𨮂
𨱖	䥩
𨷿	䦳
𨸀	𨳕
𨸁	𨳑
𨸂	閍
𨸃	閐
𨸄	䦘
𨸅	𨴗
𨸆	𨵩
𨸇	𨵸
𨸉	𨶀
𨸊	𨶏
𨸋	𨶲
𨸌	𨶮
𨸎	𨷲
𨸘	𨽏
𨸟	䧢
𩏼	䪏
𩏽	𩏪
𩏾	𩎢
𩏿	䪘
𩐀	䪗
𩓋	顂
𩖕	𩓣
𩖖	顃
𩖗	䫴
𩙥	颰
𩙦	𩗀
𩙧	䬞
𩙨	𩘹
𩙩	𩘀
𩙪	颷
𩙫	颾
𩙬	𩘺
𩙭	𩘝
𩙮	䬘
𩙯	䬝
𩙰	𩙈
𩟿	𩚛
𩠀	𩚥
𩠁	𩚵
𩠂	𩛆
𩠃	𩛩
𩠅	𩟐
𩠆	𩜦
𩠇	䭀
𩠈	䭃
𩠉	𩜇
𩠊	𩜵
𩠋	𩝔
𩠌	餸
𩠎	𩞄
𩠏	𩞦
𩠠	𩠴
𩡖	𩡣
𩧦	𩡺
𩧨	駎
𩧩	𩤊
𩧪	䮾
𩧫	駚
𩧬	𩢡
𩧭	䭿
𩧮	𩢾
𩧯	驋
𩧰	䮝
𩧱	𩥉
𩧲	駧
𩧳	𩢸
𩧴	駩
𩧵	𩢴
𩧶	𩣏
𩧸	𩣫
𩧺	駶
𩧻	𩣵
𩧼	𩣺
𩧿	䮠
𩨀	騔
𩨁	䮞
𩨂	驄
𩨃	騝
𩨄	騪
𩨅	𩤸
𩨆	𩤙
𩨇	䮫
𩨈	騟
𩨉	𩤲
𩨊	騚
𩨋	𩥄
𩨌	𩥑
𩨍	𩥇
𩨎	龭
𩨏	䮳
𩨐	𩧆
𩩈	䯤
𩬣	𩭙
𩬤	𩰀
𩭹	鬖
𩯒	𩯳
𩰰	𩰹
𩲒	𩳤
𩴌	𩴵
𩽹	魥
𩽺	𩵩
𩽻	𩵹
𩽼	鯶
𩽽	𩶱
𩽿	𩶰
𩾁	鯄
𩾂	䲖
𩾄	𩷰
𩾅	𩸃
𩾆	𩸦
𩾇	鯱
𩾈	䱙
𩾊	䱬
𩾋	䱰
𩾎	𩽇
𪉂	䲰
𪉃	鳼
𪉄	𩿪
𪉅	𪀦
𪉆	鴲
𪉈	鴜
𪉉	𪁈
𪉊	鷨
𪉋	𪀾
𪉌	𪁖
𪉍	鵚
𪉎	𪂆
𪉏	𪃏
𪉐	𪃍
𪉑	鷔
𪉒	𪄕
𪉔	𪄆
𪉕	𪇳
𪎈	䴬
𪎉	麲
𪎊	麨
𪎋	䴴
𪎌	麳
𪑅	䵳
𪔭	𪔵
𪚏	𪘀
𪚐	𪘯
𪜎	𠿕
𪞝	凙
𪟎	㔋
𪠀	𧷎
𪠟	㓄
𪠡	𠬙
𪠳	唓
𪠵	㖮
𪠸	嚛
𪠺	𠽃
𪠽	噹
𪡀	嘺
𪡃	嘪
𪡋	噞
𪡏	嗹
𪡛	㗿
𪡞	嘳
𪡺	𡃄
𪢌	㘓
𪢐	𡃤
𪢒	𡂡
𪢕	嚽
𪢖	𡅯
𪢠	囒
𪢮	圞
𪢸	墲
𪣆	埬
𪣒	堚
𪤄	𡓁
𪤚	壣
𪥠	𧹈
𪥫	孇
𪥰	嬣
𪥿	嬻
𪧀	孾
𪧘	寠
𪨊	㞞
𪨗	屩
𪨧	崙
𪨩	𡸗
𪨷	巗
𪨹	𡹬
𪩇	㟺
𪩎	巊
𪩛	𡿖
𪩷	幝
𪩸	幩
𪪏	廬
𪪑	㢗
𪪞	廧
𪪴	𢍰
𪪼	彃
𪫌	徿
𪫡	𢤩
𪫷	㦞
𪫺	憸
𪬚	𢣐
𪬯	𢤿
𪭝	𢯷
𪭢	摐
𪭧	擟
𪭯	𢶒
𪭵	掚
𪭾	撊
𪮃	㨻
𪮋	㩋
𪮖	撧
𪮳	𢺳
𪮶	攋
𪯋	㪎
𪰶	曊
𪱥	膹
𪱷	梖
𪲎	櫅
𪲔	欐
𪲛	檵
𪲮	櫠
𪳍	欇
𪳗	𣜬
𪴙	欑
𪵑	毊
𪵣	霼
𪵱	濿
𪶄	溡
𪶒	𤄷
𪶮	𣽏
𪷍	㵾
𪷽	灒
𪸕	熂
𪸩	煇
𪹀	𤑹
𪹠	𤓌
𪹳	爥
𪹹	𤒻
𪺣	𤘀
𪺪	𤜆
𪺭	犞
𪺷	獊
𪺸	𤠮
𪺻	㺜
𪺽	猌
𪻐	瑽
𪻨	瓄
𪻲	瑻
𪻺	璝
𪼋	㻶
𪼴	𤬅
𪽈	畼
𪽝	𤳷
𪽪	痮
𪽭	𤷃
𪽮	㿖
𪽴	𤺔
𪽷	瘱
𪾔	盨
𪾣	眝
𪾦	矑
𪾸	矉
𪿊	𥏝
𪿞	𥖲
𪿫	礮
𪿵	𥗇
𫀌	𥜰
𫀓	𥜐
𫀨	䅐
𫀬	䅳
𫀮	𥢷
𫁂	䆉
𫁟	竱
𫁡	鴗
𫁱	𥶽
𫁲	䉑
𫁳	𥯤
𫁷	䉶
𫁺	𥴼
𫂃	簢
𫂆	簂
𫂈	䉬
𫂖	𥴨
𫂿	𥻦
𫃗	𩏷
𫄙	糺
𫄚	䊺
𫄛	紟
𫄜	䋃
𫄝	𥾯
𫄞	䋔
𫄟	絁
𫄠	絙
𫄡	絧
𫄢	絥
𫄣	繷
𫄤	繨
𫄥	纚
𫄦	𦀖
𫄩	䋦
𫄪	𦅇
𫄫	綟
𫄬	緤
𫄭	緮
𫄮	䋼
𫄯	𦃩
𫄰	縍
𫄱	繬
𫄲	縸
𫄳	縰
𫄴	繂
𫄵	𦅈
𫄶	繈
𫄹	纗
𫅅	䍤
𫅗	羵
𫅥	𦒀
𫅭	䎙
𫅼	𦔖
𫆏	聻
𫆝	𦟼
𫆫	𦡝
𫇘	𦧺
𫇛	艣
𫇪	𦱌
𫇴	蒭
𫇽	蕽
𫈉	蕳
𫈎	葝
𫈟	蔯
𫈵	蕝
𫉁	薆
𫉄	藷
𫊪	䗅
𫊮	蠦
𫊸	蟜
𫊹	𧒯
𫊻	蟳
𫋇	蟂
𫋌	蟘
𫋲	䙔
𫋷	襗
𫋹	襓
𫋻	襘
𫌇	襵
𫌋	𧞫
𫌨	覼
𫌪	覛
𫌫	𧡴
𫌬	𧢄
𫌭	覹
𫌯	䚩
𫍐	𧭹
𫍙	訑
𫍚	訞
𫍛	訜
𫍜	詓
𫍝	諫
𫍞	𧦝
𫍟	𧦧
𫍠	䛄
𫍡	詑
𫍢	譊
𫍤	譑
𫍥	誂
𫍦	譨
𫍧	誺
𫍨	誫
𫍩	諣
𫍪	誋
𫍫	䛳
𫍬	誷
𫍭	𧩕
𫍮	誳
𫍰	諰
𫍱	諯
𫍳	諥
𫍴	謱
𫍵	謸
𫍶	𧩼
𫍷	謉
𫍸	謆
𫍹	謯
𫍺	𧫝
𫍻	譆
𫍼	𧬤
𫍾	𧭈
𫍿	譾
𫎆	豵
𫎌	貗
𫎦	贚
𫎧	䝭
𫎨	𧸘
𫎩	賝
𫎪	䞋
𫎫	贉
𫎬	贑
𫎭	䞓
𫎱	䟐
𫎳	䟆
𫎸	𧽯
𫎺	䟃
𫏃	䠆
𫏆	蹳
𫏋	蹻
𫏌	𨂐
𫏐	蹔
𫏑	𨇽
𫏕	𨆪
𫏞	𨇰
𫏨	𨇤
𫐅	軕
𫐆	轣
𫐇	軜
𫐈	軷
𫐉	軨
𫐊	軬
𫐋	𨎌
𫐌	軿
𫐍	𨌈
𫐎	輢
𫐏	輖
𫐑	輨
𫐒	輷
𫐔	𨍰
𫐕	轊
𫐖	轇
𫐗	轐
𫐘	轗
𫐙	轠
𫐷	遱
𫑘	鄟
𫑷	醶
𫓥	釟
𫓦	釨
𫓨	鈛
𫓩	鏦
𫓪	鈆
𫓫	𨥟
𫓬	鉔
𫓭	鉠
𫓮	𨪕
𫓰	銊
𫓱	鐈
𫓲	銁
𫓳	𨰋
𫓴	鉾
𫓵	鋠
𫓷	𫒡
𫓸	錽
𫓺	鐪
𫓻	錜
𫓼	𨨛
𫓽	錝
𫓾	錥
𫓿	𨨢
𫔀	鍊
𫔁	鐼
𫔂	鍉
𫔃	𨰲
𫔄	鍒
𫔅	鎍
𫔆	䥯
𫔇	鎞
𫔈	鎙
𫔉	𨰃
𫔊	鏥
𫔋	䥗
𫔌	鏾
𫔏	𨬖
𫔐	𨭸
𫔑	𨭖
𫔒	𨮳
𫔓	𨯟
𫔔	鑴
𫔕	𨰥
𫔖	𨲳
𫔭	開
𫔮	閒
𫔯	閗
𫔰	閞
𫔲	𨴹
𫔴	閵
𫔵	䦯
𫔽	𨼳
𫕚	𩀨
𫕥	霣
𫕨	𩅙
𫖃	靧
𫖅	䪊
𫖇	鞾
𫖑	𩎖
𫖒	韠
𫖓	𩏂
𫖔	韛
𫖕	韝
𫖖	𩏠
𫖪	𩑔
𫖫	䪴
𫖬	䪾
𫖭	𩒎
𫖰	䫂
𫖱	䫀
𫖲	䫟
𫖴	𩔳
𫖵	𩓥
𫖶	顅
𫖷	𩔑
𫖸	願
𫖹	顣
𫖺	䫶
𫗇	䫻
𫗈	𩗓
𫗉	𩗴
𫗊	䬓
𫗋	飋
𫗚	𩟗
𫗞	飦
𫗟	䬧
𫗠	餦
𫗡	𩚩
𫗢	飵
𫗣	飶
𫗤	𩛌
𫗥	餫
𫗦	餔
𫗨	𩛡
𫗩	饠
𫗪	餧
𫗫	餬
𫗬	餪
𫗭	餵
𫗮	餭
𫗯	餱
𫗰	䭔
𫗱	䭑
𫗳	𩝽
𫗵	饟
𫘛	馯
𫘞	駞
𫘟	駊
𫘠	駤
𫘡	駫
𫘣	駻
𫘤	騃
𫘥	騉
𫘩	騜
𫘫	騴
𫘭	騻
𫘮	䮰
𫘯	驓
𫘰	驙
𫘱	驨
𫘽	鬠
𫙂	𩯁
𫚈	鱮
𫚉	魟
𫚊	鰑
𫚋	鱄
𫚌	魦
𫚍	魵
𫚎	𩶁
𫚏	䱁
𫚐	䱀
𫚑	鮅
𫚒	鮄
𫚓	鮤
𫚔	鮰
𫚗	鮯
𫚘	𩻮
𫚙	鯆
𫚚	鮿
𫚛	鮵
𫚜	䲅
𫚝	𩸄
𫚞	鯬
𫚟	𩸡
𫚠	䱧
𫚡	鯞
𫚢	鰋
𫚣	鯾
𫚤	鰦
𫚥	鰕
𫚦	鰫
𫚧	鰽
𫚨	𩻗
𫚩	𩻬
𫚪	鱊
𫚫	鱢
𫚬	𩼶
𫛚	鳽
𫛛	鳷
𫛜	鴀
𫛝	鴅
𫛞	鴃
𫛟	鸗
𫛠	𩿤
𫛡	鴔
𫛢	鸋
𫛣	鴥
𫛤	鴐
𫛥	鵊
𫛦	鴮
𫛧	𪀖
𫛨	鵧
𫛩	鴳
𫛪	鴽
𫛫	鶰
𫛬	䳜
𫛮	䳤
𫛯	鶭
𫛰	䳢
𫛱	鵫
𫛲	鵰
𫛳	鵩
𫛴	鷤
𫛵	鶌
𫛶	鶒
𫛷	鶦
𫛸	鶗
𫛹	𪃧
𫛺	䳧
𫛻	𪃒
𫛼	䳫
𫛽	鷅
𫛾	𪆷
𫜀	鷐
𫜁	鷩
𫜂	𪅂
𫜃	鷣
𫜄	鷷
𫜅	䴋
𫜊	𪉸
𫜑	麷
𫜒	䴱
𫜓	𪌭
𫜔	䴽
𫜕	𪍠
𫜙	䵴
𫜟	𪓰
𫜨	䶕
𫜩	齧
𫜪	齩
𫜫	𫜦
𫜬	齰
𫜭	齭
𫜮	齴
𫜯	𪙏
𫜰	齾
𫜲	龓
𫜳	䶲
𫝈	㑮
𫝋	𠐊
𫝦	㛝
𫝧	㜐
𫝨	媈
𫝩	嬦
𫝪	𡟫
𫝫	婡
𫝬	嬇
𫝭	孆
𫝮	孄
𫝵	嶹
𫞅	𦠅
𫞗	潣
𫞚	澬
𫞛	㶆
𫞝	灍
𫞠	爧
𫞡	爃
𫞢	𤛱
𫞣	㹽
𫞥	珼
𫞦	璾
𫞧	𤩂
𫞨	璼
𫞷	𥢶
𫟃	絍
𫟄	綋
𫟆	緟
𫟇	𦆲
𫟑	䖅
𫟕	䕤
𫟞	訨
𫟟	詊
𫟠	譂
𫟡	誴
𫟢	䜖
𫟤	䡐
𫟥	䡩
𫟫	𨞺
𫟬	𨟊
𫟲	釚
𫟳	釲
𫟴	鈖
𫟵	鈗
𫟶	銏
𫟷	鉝
𫟸	鉽
𫟺	䤤
𫟻	銂
𫟽	𨧰
𫟾	𨩰
𫟿	鎈
𫠀	䥄
𫠁	鑉
𫠂	閝
𫠅	韚
𫠇	𩖰
𫠈	䫾
𫠋	騼
𫠌	𩦠
𫠏	𩵦
𫠐	魽
𫠑	䱸
𫠒	鱆
𫠖	𩿅
𫧃	𣍐
𫧮	𪋿
𫬐	㘔
𬭭	鏚
𬸯	鷿
𰬸	繐
𰰨	菕
𰶎	譅
𰾄	鋂
𰾭	鑀
𱊜	𪈼
内	內
匀	勻
户	戶
册	冊
吕	呂
丢	丟
争	爭
决	決
抛	拋
吴	吳
呐	吶
秃	禿
囱	囪
删	刪
况	況
弃	棄
兑	兌
没	沒
灾	災
卧	臥
咏	詠
秆	稈
侣	侶
刹	剎
肴	餚
净	淨
泪	淚
屉	屜
届	屆
叁	叄
挣	掙
荆	荊
栅	柵
叙	敘
脉	脈
狰	猙
兹	茲
宫	宮
换	換
耻	恥
晋	晉
栖	棲
唤	喚
笋	筍
凉	涼
烟	煙
涣	渙
悦	悅
剥	剝
娱	娛
黄	黃
厢	廂
虚	虛
睁	睜
脚	腳
脱	脫
够	夠
猪	豬
猫	貓
凑	湊
减	減
盗	盜
焕	煥
窑	窯
厨	廚
厦	廈
税	稅
筝	箏
粤	粵
奥	奧
猬	蝟
痪	瘓
羡	羨
温	溫
游	游
游	遊
雇	僱
强	強
携	攜
摇	搖
蜕	蛻
遥	遙
禀	稟
痴	癡
韵	韻
滚	滾
叠	疊
静	靜
碱	鹼
撑	撐
横	橫
踪	蹤
凛	凜
潜	潛
橱	櫥
虬	虯
殁	歿
牦	犛
瓮	甕
兖	兗
炖	燉
姗	姍
虱	蝨
珐	琺
栀	梔
峥	崢
俣	俁
彦	彥
籼	秈
姹	奼
莅	蒞
隽	雋
疴	痾
衮	袞
棁	梲
厩	廄
眦	眥
偬	傯
渌	淥
椁	槨
弑	弒
愠	慍
幂	冪
媪	媼
氲	氳
腼	靦
腭	齶
瑶	瑤
戬	戩
厮	廝
嘘	噓
麽	麼
潴	瀦
廪	廩
檩	檁
嬷	嬤
鞲	韝
蹰	躕
蘖	櫱
鼹	鼴
芈	羋
卺	巹
垴	堖
陧	隉
稆	穭
榅	榲
暅	𣈶
腽	膃
煴	熅
蕰	薀
橥	櫫
糇	餱
懔	懍
𰻝	𰻞
鿭	鉨
𫟷	鉝
大家	大家
昆仑	崑崙
国家	國家
一个	一個
论坛	論壇
这个	這個
系统	系統
发展	發展
技术	技術
发布	發佈
标准	標準
发表	發表
联系	聯繫
个人	個人
最后	最後
发现	發現
游戏	遊戲
对于	對於
只有	只有
关于	關於
开发	開發
只是	只是
由于	由於
发生	發生
这里	這裏
那个	那個
之后	之後
然后	然後
刚才	剛纔
方面	方面
表示	表示
数据	數據
关系	關係
类别	類別
两个	兩個
根据	根據
控制	控制
以后	以後
制作	製作
当然	當然
历史	歷史
计划	計劃
只要	只要
当前	當前
注意	注意
特别	特別
准备	準備
获得	獲得
才能	纔能
别人	別人
代表	代表
并且	並且
采用	採用
级别	級別
终于	終於
旅游	旅遊
制度	制度
整个	整個
台湾	臺灣
咨询	諮詢
列表	列表
注册	註冊
全面	全面
下面	下面
只能	只能
关注	關注
当时	當時
几个	幾個
表现	表現
是个	是個
于是	於是
一面	一面
后悔	後悔
心里	心裏
人才	人才
里面	裏面
几乎	幾乎
艺术	藝術
推荐	推薦
制造	製造
后来	後來
发行	發行
回答	回答
导致	導致
面对	面對
回来	回來
面前	面前
方向	方向
规划	規劃
系列	系列
分别	分別
恢复	恢復
三个	三個
相当	相當
属于	屬於
每个	每個
面积	面積
体系	體系
发挥	發揮
回复	回覆
并不	並不
发出	發出
轻松	輕鬆
发送	發送
回到	回到
公布	公佈
表情	表情
经历	經歷
采取	採取
日志	日誌
上面	上面
尽管	儘管
用于	用於
返回	返回
那里	那裏
回家	回家
限制	限制
万元	萬元
干部	幹部
应当	應當
一只	一隻
界面	界面
制定	制定
老板	老闆
有个	有個
当地	當地
休闲	休閒
采购	採購
千万	千萬
后面	後面
机制	機制
分钟	分鐘
位于	位於
党员	黨員
复制	複製
周围	周圍
多个	多個
才是	纔是
公里	公里
平台	平臺
个性	個性
只好	只好
当年	當年
表达	表達
群发	群發
表明	表明
愿意	願意
标签	標籤
发言	發言
批准	批准
前面	前面
杂志	雜誌
性别	性別
哪里	哪裏
宣布	宣佈
回去	回去
家里	家裏
处于	處於
复杂	複雜
哪个	哪個
别的	別的
同志	同志
画面	畫面
游客	遊客
外面	外面
表演	表演
战斗	戰鬥
采访	採訪
至于	至於
各个	各個
面临	面臨
批发	批發
背后	背後
防止	防止
四个	四個
旁边	旁邊
在于	在於
学历	學歷
回忆	回憶
云南	雲南
主板	主板
依据	依據
研发	研發
身后	身後
特征	特徵
尽快	儘快
头发	頭髮
本周	本週
签名	簽名
今后	今後
基于	基於
才会	纔會
页面	頁面
制品	製品
只见	只見
尽量	盡量
咱们	咱們
并非	並非
几天	幾天
重复	重複
表面	表面
准确	準確
一致	一致
区别	區別
策划	策劃
走向	走向
出发	出發
预防	預防
当中	當中
体制	體制
随后	隨後
地面	地面
台北	臺北
几次	幾次
适当	適當
标志	標誌
某个	某個
获取	獲取
桌面	桌面
手里	手裏
见面	見面
不愿	不願
只需	只需
先后	先後
后果	後果
学术	學術
出台	出臺
当初	當初
注明	註明
回应	回應
委托	委託
面向	面向
面议	面議
手术	手術
百万	百萬
风云	風雲
据说	據說
回头	回頭
郁闷	鬱悶
简历	簡歷
当天	當天
鉴定	鑑定
网游	網遊
引发	引發
四周	四周
注重	注重
回事	回事
一台	一臺
一周	一週
几年	幾年
冲击	衝擊
冲突	衝突
对面	對面
防治	防治
前后	前後
发达	發達
反复	反覆
证据	證據
眼里	眼裏
周边	周邊
模糊	模糊
版面	版面
舞台	舞臺
签订	簽訂
识别	識別
宿舍	宿舍
备注	備註
沙发	沙發
修复	修復
将于	將於
分布	分佈
愿望	願望
美术	美術
症状	症狀
周末	週末
局面	局面
局长	局長
汇款	匯款
编制	編制
据悉	據悉
模板	模板
只会	只會
干净	乾淨
发放	發放
场面	場面
一向	一向
发动	發動
防御	防禦
面板	面板
研制	研製
回报	回報
放松	放鬆
五个	五個
嘴里	嘴裏
若干	若干
其余	其餘
党委	黨委
向上	向上
发帖	發帖
尸体	屍體
售后	售後
怀里	懷裏
面试	面試
复习	複習
当作	當作
板块	板塊
收获	收獲
转向	轉向
合并	合併
地板	地板
万人	萬人
过后	過後
当代	當代
和弦	和弦
冲动	衝動
别墅	別墅
低于	低於
试卷	試卷
平面	平面
爆发	爆發
回顾	回顧
摆脱	擺脫
才有	纔有
结局	結局
汇报	匯報
过于	過於
发射	發射
正面	正面
落后	落後
个股	個股
个体	個體
出于	出於
消防	消防
布局	佈局
并将	並將
挣扎	掙扎
告别	告別
周期	週期
发觉	發覺
个别	個別
向前	向前
发起	發起
当今	當今
每周	每週
不准	不准
身旁	身旁
表格	表格
精致	精緻
万吨	萬噸
防范	防範
报表	報表
奋斗	奮鬥
半个	半個
回收	回收
书面	書面
高于	高於
发票	發票
仪表	儀表
干脆	乾脆
布置	佈置
两只	兩隻
复合	復合
发明	發明
总局	總局
当场	當場
好几	好幾
心脏	心臟
差别	差別
当成	當成
电台	電臺
收回	收回
并未	並未
风采	風采
抑制	抑制
占据	佔據
格局	格局
防守	防守
战术	戰術
当日	當日
天才	天才
回帖	回帖
注定	註定
回归	回歸
松下	松下
强制	強制
局部	局部
后者	後者
外表	外表
斗争	鬥爭
万一	萬一
发给	發給
正当	正當
外汇	外匯
后期	後期
防护	防護
激发	激發
赞同	贊同
周年	週年
后台	後臺
剩余	剩餘
面子	面子
纤维	纖維
干燥	乾燥
法制	法制
几种	幾種
夸张	誇張
几分	幾分
签约	簽約
一杯	一杯
致命	致命
象征	象徵
业余	業餘
大于	大於
干扰	干擾
签署	簽署
等于	等於
获悉	獲悉
周刊	週刊
获奖	獲獎
港台	港臺
意志	意志
防盗	防盜
白云	白雲
邮局	郵局
康复	康復
忧郁	憂鬱
游泳	游泳
征集	徵集
签证	簽證
征收	徵收
几句	幾句
呼吁	呼籲
注视	注視
只得	只得
个个	個個
几位	幾位
日历	日曆
征服	征服
几点	幾點
定制	定製
占地	佔地
夜里	夜裏
水面	水面
不只	不只
占用	佔用
采集	採集
千里	千里
发育	發育
烟台	煙臺
答复	答覆
长发	長髮
面上	面上
不当	不當
为准	爲準
历程	歷程
善于	善於
细致	細緻
发货	發貨
周一	週一
占有	佔有
制约	制約
此后	此後
倾向	傾向
书签	書籤
叹息	嘆息
尽力	盡力
周五	週五
词汇	詞彙
发电	發電
抑郁	抑鬱
便于	便於
封面	封面
散发	散發
汇率	匯率
层面	層面
致富	致富
制成	製成
水准	水準
颁发	頒發
面包	麵包
制药	製藥
个数	個數
来回	來回
几十	幾十
面料	面料
划分	劃分
当下	當下
万分	萬分
占领	佔領
准则	準則
事后	事後
荣获	榮獲
防水	防水
日后	日後
大致	大致
潇洒	瀟灑
六个	六個
借鉴	借鑑
屋里	屋裏
报复	報復
首发	首發
震荡	震盪
志愿	志願
十几	十幾
城里	城裏
表单	表單
尽情	盡情
制订	制訂
面貌	面貌
骨干	骨幹
自愿	自願
征求	徵求
指向	指向
向往	嚮往
专注	專注
十个	十個
颁布	頒佈
回国	回國
发光	發光
每当	每當
注入	注入
导游	導遊
发作	發作
一旁	一旁
导向	導向
手表	手錶
宁愿	寧願
这回	這回
不尽	不盡
游览	遊覽
突发	突發
面孔	面孔
感叹	感歎
向下	向下
回避	迴避
汇总	匯總
复发	復發
回落	回落
之余	之餘
无尽	無盡
尽头	盡頭
上周	上週
扎实	紮實
平板	平板
复活	復活
录制	錄製
表彰	表彰
多余	多餘
游民	游民
周六	週六
心愿	心願
找回	找回
一回	一回
十万	十萬
时钟	時鐘
强奸	強姦
而后	而後
国防	國防
赞助	贊助
游侠	游俠
表扬	表揚
幕后	幕後
万能	萬能
发泄	發洩
制止	制止
依托	依託
几步	幾步
别说	別說
获利	獲利
致使	致使
癌症	癌症
转发	轉發
光纤	光纖
才行	纔行
周日	週日
发誓	發誓
万千	萬千
糊涂	糊塗
武术	武術
小于	小於
并购	併購
摩托	摩托
向着	向著
干吗	幹嗎
全局	全局
方才	方纔
向来	向來
意向	意向
拜托	拜託
分局	分局
万物	萬物
向外	向外
皇后	皇后
法术	法術
后卫	後衛
只怕	只怕
几百	幾百
发售	發售
意愿	意願
后退	後退
发信	發信
鉴于	鑑於
一万	一萬
面部	面部
瞄准	瞄準
万里	萬里
开辟	開闢
才好	纔好
发烧	發燒
致电	致電
负面	負面
党政	黨政
村里	村裏
向后	向後
改制	改制
带回	帶回
面色	面色
上当	上當
轮回	輪迴
瀑布	瀑布
侧面	側面
西游	西遊
其后	其後
台上	臺上
冲出	衝出
制服	制服
系数	係數
注射	注射
后勤	後勤
局势	局勢
满面	滿面
死后	死後
往后	往後
所致	所致
只用	只用
发型	髮型
后续	後續
以致	以致
阳台	陽臺
发呆	發獃
面具	面具
发掘	發掘
但愿	但願
征文	徵文
几家	幾家
冲进	衝進
源于	源於
路面	路面
布什	布什
启发	啟發
七个	七個
面容	面容
抵制	抵制
后市	後市
不舍	不捨
蒙古	蒙古
发财	發財
发病	發病
压制	壓制
赞成	贊成
当真	當真
八个	八個
换个	換個
注释	註釋
才华	才華
台阶	臺階
发热	發熱
赞美	讚美
历经	歷經
回首	回首
当晚	當晚
柜台	櫃臺
防伪	防僞
周四	週四
干预	干預
托管	託管
复仇	復仇
多于	多於
防火	防火
发音	發音
复旦	復旦
店面	店面
印发	印發
敢于	敢於
岩石	岩石
梦里	夢裏
当面	當面
秒钟	秒鐘
称赞	稱讚
签字	簽字
绘制	繪製
双向	雙向
历代	歷代
房里	房裏
自制	自製
冲着	衝著
周三	週三
当局	當局
台风	颱風
僵尸	殭屍
格斗	格鬥
几何	幾何
准时	準時
遍布	遍佈
美发	美髮
向导	嚮導
复兴	復興
后方	後方
面膜	面膜
回味	回味
大局	大局
白发	白髮
发到	發到
抓获	抓獲
管制	管制
易于	易於
下发	下發
图表	圖表
票据	票據
汇编	彙編
并用	並用
闲聊	閒聊
表决	表決
冲刺	衝刺
下游	下游
当即	當即
生于	生於
摆放	擺放
挽回	挽回
万年	萬年
少于	少於
出面	出面
周二	週二
来历	來歷
发扬	發揚
回车	迴車
上游	上游
汇集	彙集
当选	當選
单个	單個
回合	回合
游人	遊人
鉴别	鑑別
以防	以防
魔术	魔術
术语	術語
出游	出遊
窗帘	窗簾
乐坛	樂壇
离别	離別
推向	推向
遏制	遏制
退回	退回
核准	核准
散布	散佈
周到	周到
回想	回想
发抖	發抖
信托	信託
置于	置於
横向	橫向
余额	餘額
游记	遊記
迎面	迎面
获胜	獲勝
杯子	杯子
充当	充當
赞赏	讚賞
下周	下週
亿万	億萬
后代	後代
防线	防線
征婚	徵婚
干涉	干涉
山谷	山谷
万岁	萬歲
详尽	詳盡
周岁	週歲
天后	天后
开采	開採
浓郁	濃郁
布满	佈滿
表白	表白
几率	機率
漫游	漫遊
余地	餘地
赞叹	讚歎
收发	收發
越发	越發
松开	鬆開
摆出	擺出
农历	農曆
表态	表態
悠闲	悠閒
急于	急於
调制	調製
采纳	採納
只因	只因
胡乱	胡亂
酒杯	酒杯
干掉	幹掉
恰当	恰當
历年	歷年
附注	附註
复苏	復蘇
一并	一並
后天	後天
后人	後人
问卷	問卷
前台	前臺
寄托	寄託
回升	回升
制冷	制冷
惊叹	驚歎
不干	不干
面目	面目
闹钟	鬧鐘
死于	死於
里头	裏頭
投注	投注
打发	打發
并于	並於
复印	複印
数万	數萬
对准	對準
复出	復出
勇于	勇於
两旁	兩旁
糊糊	糊糊
萝卜	蘿蔔
自发	自發
后门	後門
历时	歷時
胡子	鬍子
婚后	婚後
丑陋	醜陋
据此	據此
几条	幾條
背面	背面
台独	臺獨
挽救	挽救
布线	佈線
峡谷	峽谷
注销	註銷
万万	萬萬
发文	發文
辨别	辨別
克制	克制
午后	午後
表述	表述
党组	黨組
面粉	麵粉
当当	噹噹
用尽	用盡
台下	臺下
趋于	趨於
制动	制動
宽松	寬鬆
情愿	情願
万事	萬事
巡回	巡迴
投向	投向
当家	當家
旁人	旁人
定向	定向
抵御	抵禦
年后	年後
基准	基準
标注	標註
沉淀	沉澱
台词	臺詞
干活	幹活
个头	個頭
入党	入黨
汇聚	匯聚
朝向	朝向
动向	動向
蒸发	蒸發
饥饿	飢餓
游玩	遊玩
荡漾	盪漾
祝愿	祝願
党建	黨建
事发	事發
当着	當著
闲置	閒置
能干	能幹
缓冲	緩衝
上台	上臺
防腐	防腐
篮板	籃板
所获	所獲
制剂	製劑
兴致	興致
极致	極致
四面	四面
台商	臺商
防备	防備
摇摆	搖擺
露面	露面
舍得	捨得
抢占	搶佔
佣兵	傭兵
并肩	並肩
担当	擔當
几只	幾隻
党校	黨校
游走	遊走
内向	內向
冲洗	沖洗
游行	遊行
筹划	籌劃
出局	出局
冲向	衝向
两周	兩週
只顾	只顧
摆手	擺手
卷入	捲入
提防	提防
去向	去向
歌坛	歌壇
有余	有餘
里边	裏邊
回放	回放
板材	板材
纤细	纖細
深表	深表
发酵	發酵
历来	歷來
丑闻	醜聞
云集	雲集
长叹	長嘆
几千	幾千
冲天	沖天
赛后	賽後
秀发	秀髮
发自	發自
复试	複試
乌云	烏雲
个案	個案
发疯	發瘋
动荡	動盪
朴实	樸實
配制	配製
赶回	趕回
冲浪	衝浪
雇员	雇員
当众	當眾
印制	印製
大发	大發
取向	取向
金发	金髮
海面	海面
约占	約佔
回馈	回饋
布料	布料
有别	有別
两万	兩萬
防卫	防衛
面纱	面紗
台式	臺式
争斗	爭鬥
不复	不復
决斗	決鬥
双面	雙面
太后	太后
触发	觸發
迷糊	迷糊
乐于	樂於
个子	個子
当心	當心
滞后	滯後
鉴赏	鑑賞
车里	車裏
含糊	含糊
面瘫	面癱
秀才	秀才
制裁	制裁
饼干	餅乾
斗志	鬥志
趋向	趨向
别名	別名
复古	復古
后背	後背
节后	節後
摆设	擺設
防疫	防疫
胡同	衚衕
批复	批覆
哽咽	哽咽
闲着	閒著
党性	黨性
化纤	化纖
席卷	席捲
政党	政黨
船只	船隻
里程	里程
召回	召回
托盘	托盤
一发	一發
制式	制式
淀粉	澱粉
万种	萬種
木板	木板
征战	征戰
墙面	牆面
打斗	打鬥
党内	黨內
朴素	樸素
冲破	衝破
面谈	面談
局限	侷限
九个	九個
防晒	防晒
咽喉	咽喉
脉冲	脈衝
酒后	酒後
回荡	迴盪
肝脏	肝臟
后备	後備
游荡	游蕩
并存	並存
两面	兩面
尽是	盡是
青云	青雲
赞扬	讚揚
斗气	鬥氣
诱发	誘發
胡说	胡說
术后	術後
衬托	襯托
别致	別致
才刚	纔剛
肮脏	骯髒
只管	只管
钢板	鋼板
几时	幾時
别看	別看
术士	術士
海里	海里
饭后	飯後
面条	麵條
占卜	占卜
兼并	兼併
炎症	炎症
三万	三萬
出征	出征
长征	長征
未尽	未盡
木制	木製
制备	製備
雇主	僱主
后院	後院
门面	門面
夸奖	誇獎
布衣	布衣
空闲	空閒
尽早	儘早
精准	精準
通向	通向
回信	回信
叹气	嘆氣
精制	精製
面世	面世
监制	監製
几岁	幾歲
发亮	發亮
复原	復原
淋漓	淋漓
并列	並列
当月	當月
防汛	防汛
武当	武當
体坛	體壇
英才	英才
奔向	奔向
征得	徵得
别扭	彆扭
表哥	表哥
战后	戰後
开局	開局
发问	發問
特制	特製
取回	取回
只求	只求
舍弃	捨棄
眼帘	眼簾
骗局	騙局
立志	立志
防空	防空
飘荡	飄蕩
产后	產後
当红	當紅
搏斗	搏鬥
后世	後世
捕获	捕獲
挽留	挽留
洒脱	灑脫
云雾	雲霧
星系	星系
万家	萬家
松弛	鬆弛
回身	回身
后记	後記
板凳	板凳
据称	據稱
流向	流向
忙于	忙於
余下	餘下
栏杆	欄杆
多发	多發
归于	歸於
致力	致力
内脏	內臟
表妹	表妹
才子	才子
雪松	雪松
查获	查獲
岳阳	岳陽
游离	游離
复议	複議
如愿	如願
征地	徵地
脑后	腦後
振荡	振盪
摆动	擺動
夸大	誇大
多云	多雲
台球	檯球
学系	學系
回响	迴響
三只	三隻
发力	發力
优于	優於
企划	企劃
雇佣	僱傭
并行	並行
周密	周密
签发	簽發
会面	會面
看板	看板
游乐	遊樂
发愁	發愁
钟表	鐘錶
周遭	周遭
迈向	邁向
妥当	妥當
讲台	講臺
硅谷	硅谷
致敬	致敬
许愿	許願
古朴	古樸
历届	歷屆
稍后	稍後
足坛	足壇
路旁	路旁
激荡	激盪
病症	病症
启蒙	啟蒙
破获	破獲
片面	片面
注目	注目
发火	發火
茶杯	茶杯
佣金	佣金
黑发	黑髮
钟声	鐘聲
短发	短髮
内蒙	內蒙
吕布	呂布
神采	神采
黑板	黑板
回音	回音
冲锋	衝鋒
剑术	劍術
上万	上萬
单据	單據
亚当	亞當
面值	面值
畅游	暢遊
征税	徵稅
别提	別提
后头	後頭
得当	得當
吊带	吊帶
纵向	縱向
回转	回轉
后边	後邊
党章	黨章
百里	百里
树干	樹幹
单向	單向
向左	向左
耗尽	耗盡
毛发	毛髮
尽心	盡心
卷轴	卷軸
防爆	防爆
台海	臺海
定于	定於
总汇	總匯
五万	五萬
向东	向東
表露	表露
周旋	周旋
致癌	致癌
全党	全黨
复读	複讀
干旱	乾旱
当头	當頭
展台	展臺
钟情	鍾情
获准	獲准
向右	向右
浮云	浮雲
反面	反面
周身	周身
夺回	奪回
并重	並重
邢台	邢臺
卷烟	捲煙
凌云	凌雲
谨防	謹防
赞誉	讚譽
淫荡	淫蕩
站台	站臺
边防	邊防
只须	只須
闲话	閒話
喧哗	喧譁
退后	退後
样板	樣板
成才	成才
当兵	當兵
反向	反向
看台	看臺
回眸	回眸
抽签	抽籤
擂台	擂臺
茶几	茶几
富于	富於
周易	周易
别处	別處
复查	複查
雅致	雅致
云彩	雲彩
标致	標致
几经	幾經
殆尽	殆盡
侵占	侵佔
致死	致死
盘面	盤面
复式	複式
发丝	髮絲
划破	劃破
甘愿	甘願
甲板	甲板
驳回	駁回
免征	免徵
松动	鬆動
偏向	偏向
后裔	後裔
北面	北面
交汇	交匯
奇才	奇才
回旋	迴旋
射向	射向
镜面	鏡面
脱发	脫髮
云海	雲海
致辞	致辭
收据	收據
不致	不致
发威	發威
分发	分發
牵制	牽制
制图	製圖
扑面	撲面
叮当	叮噹
采样	採樣
板书	板書
电表	電錶
闲人	閒人
斗士	鬥士
博采	博採
英里	英里
防身	防身
北斗	北斗
纤纤	纖纖
干啥	幹啥
回族	回族
曼谷	曼谷
口才	口才
发声	發聲
才艺	才藝
台面	檯面
逆向	逆向
语系	語系
挥发	揮發
课后	課後
密布	密佈
星云	星雲
流云	流雲
万丈	萬丈
专制	專制
窗台	窗臺
钟爱	鍾愛
几多	幾多
才女	才女
忠于	忠於
年鉴	年鑑
无几	無幾
蒙面	蒙面
胡须	鬍鬚
一干	一干
景致	景致
直面	直面
赵云	趙雲
转回	轉回
并发	併發
回城	回城
彩云	彩雲
利于	利於
水系	水系
防洪	防洪
取舍	取捨
维系	維繫
回扣	回扣
死党	死黨
遨游	遨遊
冲入	衝入
周转	周轉
发怒	發怒
驻扎	駐紮
案发	案發
托福	託福
划定	劃定
干事	幹事
采摘	採摘
下回	下回
谋划	謀劃
放荡	放蕩
采矿	採礦
获赠	獲贈
征管	徵管
阅历	閱歷
残余	殘餘
面授	面授
节制	節制
学制	學制
别样	別樣
采暖	採暖
几块	幾塊
干警	幹警
复方	複方
发麻	發麻
看准	看準
小丑	小醜
神志	神志
肾脏	腎臟
体面	體面
南面	南面
包扎	包紮
防毒	防毒
发白	發白
资历	資歷
面颊	面頰
独占	獨佔
闲暇	閒暇
难于	難於
后盾	後盾
发车	發車
万户	萬戶
低谷	低谷
道别	道別
征兆	徵兆
核发	核發
后宫	後宮
并举	並舉
杠杆	槓桿
院系	院系
松懈	鬆懈
地表	地表
发芽	發芽
逐个	逐個
下台	下臺
据点	據點
盈余	盈餘
居于	居於
湖面	湖面
后排	後排
丑恶	醜惡
攻防	攻防
影坛	影壇
征途	征途
纱布	紗布
里外	裏外
汇市	匯市
里昂	里昂
回程	回程
奖杯	獎盃
布尔	布爾
万般	萬般
注塑	注塑
会后	會後
奴才	奴才
钟头	鐘頭
三面	三面
制片	製片
僵局	僵局
铲除	剷除
区划	區劃
医术	醫術
如云	如雲
并称	並稱
当官	當官
色系	色系
游子	游子
汉奸	漢奸
几度	幾度
雇用	僱用
划算	划算
发狂	發狂
登台	登臺
市里	市裏
制胜	制勝
发话	發話
布雷	佈雷
始发	始發
追回	追回
周公	周公
周报	週報
攀岩	攀巖
别离	別離
赌注	賭注
杆菌	桿菌
征用	徵用
石板	石板
适于	適於
万象	萬象
摆布	擺佈
严防	嚴防
铜板	銅板
表姐	表姐
撤回	撤回
表率	表率
颜面	顏面
回路	回路
文坛	文壇
赞许	讚許
御史	御史
愈发	愈發
云层	雲層
岳父	岳父
万众	萬眾
烘干	烘乾
游艇	遊艇
受制	受制
复位	復位
吊销	吊銷
布艺	布藝
介于	介於
生姜	生薑
迫于	迫於
历练	歷練
向阳	向陽
只读	只讀
梦游	夢遊
摆弄	擺弄
冲撞	衝撞
踏板	踏板
揭发	揭發
坛子	罈子
胡闹	胡鬧
准许	准許
收复	收復
中游	中游
蒙蒙	蒙蒙
费尽	費盡
暴发	暴發
谷底	谷底
干线	幹線
复牌	復牌
采光	採光
发红	發紅
月历	月曆
划拨	劃撥
精辟	精闢
病历	病歷
肥皂	肥皂
善后	善後
闲逛	閒逛
东面	東面
下注	下注
没准	沒準
攻占	攻佔
抒发	抒發
获益	獲益
主干	主幹
便当	便當
表皮	表皮
进发	進發
云云	云云
镖局	鏢局
适才	適纔
回话	回話
摆平	擺平
云天	雲天
注解	註解
回乡	回鄉
影后	影后
飞云	飛雲
当街	當街
烟云	煙雲
王后	王后
应征	應徵
后座	後座
后缀	後綴
二胡	二胡
哗啦	嘩啦
据传	據傳
周全	周全
举杯	舉杯
焕发	煥發
质朴	質樸
骗术	騙術
赎回	贖回
云霄	雲霄
防潮	防潮
闯荡	闖蕩
冲压	衝壓
饥渴	飢渴
陷于	陷於
漓江	灕江
发炎	發炎
直板	直板
游历	遊歷
战局	戰局
并进	並進
几许	幾許
奸商	奸商
家当	家當
书局	書局
励志	勵志
回声	回聲
台灯	檯燈
市面	市面
历任	歷任
只身	隻身
平复	平復
外向	外向
风向	風向
摆明	擺明
脸面	臉面
并入	併入
故里	故里
自尽	自盡
哗哗	嘩嘩
松手	鬆手
阅卷	閱卷
理发	理髮
并排	並排
西面	西面
起哄	起鬨
只限	只限
开征	開徵
松树	松樹
准予	准予
布丁	布丁
文采	文采
松散	鬆散
桌布	桌布
比划	比劃
尽兴	盡興
挥洒	揮灑
淳朴	淳樸
面市	面市
远征	遠征
祭坛	祭壇
托运	託運
警钟	警鐘
表象	表象
几倍	幾倍
胶卷	膠捲
后劲	後勁
受尽	受盡
呜咽	嗚咽
志向	志向
染发	染髮
汇票	匯票
回望	回望
杯赛	盃賽
尽责	盡責
绝症	絕症
咱俩	咱倆
表层	表層
平局	平局
回流	回流
拉面	拉麵
复核	複核
挂历	掛曆
四万	四萬
发泡	發泡
发球	發球
滑板	滑板
喷洒	噴灑
卷发	捲髮
当先	當先
割舍	割捨
致意	致意
创汇	創匯
苦于	苦於
岳飞	岳飛
缴获	繳獲
派发	派發
连发	連發
征询	徵詢
汇价	匯價
尽职	盡職
汇入	匯入
哗然	譁然
积淀	積澱
面庞	面龐
扎根	扎根
发黑	發黑
游说	遊說
上吊	上吊
获救	獲救
冲淡	沖淡
发散	發散
迂回	迂迴
奸笑	奸笑
菜系	菜系
周瑜	周瑜
表弟	表弟
谷物	穀物
兄台	兄台
亲历	親歷
霸占	霸佔
旁观	旁觀
签到	簽到
勾当	勾當
防震	防震
征稿	徵稿
游牧	游牧
征程	征程
吧台	吧臺
防尘	防塵
发黄	發黃
制版	製版
佣人	傭人
炮制	炮製
几回	幾回
讲坛	講壇
发软	發軟
招致	招致
扫荡	掃蕩
症结	癥結
回回	回回
碰面	碰面
政局	政局
历险	歷險
发难	發難
获知	獲知
校舍	校舍
蒙蔽	蒙蔽
才智	才智
发笑	發笑
游资	游資
邻里	鄰里
冲刷	沖刷
倾注	傾注
缝制	縫製
乡里	鄉里
富余	富餘
汇合	匯合
缩回	縮回
税制	稅制
棱角	稜角
好个	好個
引向	引向
解雇	解僱
板卡	板卡
钟楼	鐘樓
只当	只當
实干	實幹
干涸	乾涸
发稿	發稿
定局	定局
脏话	髒話
历尽	歷盡
回暖	回暖
板子	板子
炼制	煉製
建制	建制
台资	臺資
施舍	施捨
吊顶	吊頂
复生	復生
画卷	畫卷
斗篷	斗篷
香皂	香皂
铁杆	鐵桿
回访	回訪
清闲	清閒
政坛	政壇
尽数	盡數
仿制	仿製
见于	見於
纤体	纖體
附表	附表
冗余	冗餘
干枯	乾枯
干粮	乾糧
才干	才幹
算术	算術
当归	當歸
干练	幹練
帆布	帆布
送别	送別
棉布	棉布
采风	採風
周折	周折
布景	佈景
迷蒙	迷濛
铁板	鐵板
向量	向量
肚里	肚裏
呆板	獃板
台币	臺幣
云端	雲端
后事	後事
闲谈	閒談
门板	門板
泡面	泡麵
课余	課餘
稻谷	稻穀
警局	警局
坦荡	坦蕩
后生	後生
来向	來向
松软	鬆軟
奋发	奮發
难当	難當
游击	游擊
致谢	致謝
发胖	發胖
致以	致以
面相	面相
布袋	布袋
防务	防務
相向	相向
回廊	迴廊
截获	截獲
松鼠	松鼠
复审	複審
舍利	舍利
死尸	死屍
霉菌	黴菌
应尽	應盡
面罩	面罩
致病	致病
内里	內裏
发廊	髮廊
防风	防風
认准	認準
世面	世面
答卷	答卷
国别	國別
叫板	叫板
游船	遊船
五谷	五穀
后腿	後腿
冲印	沖印
发卡	髮卡
灌注	灌注
单面	單面
征兵	徵兵
余款	餘款
尸骨	屍骨
游动	游動
干洗	乾洗
曲面	曲面
采编	採編
洒落	灑落
阴郁	陰鬱
免于	免於
防病	防病
公历	公曆
回绝	回絕
岳母	岳母
烘托	烘托
三周	三週
回击	回擊
郁郁	鬱鬱
轮奸	輪姦
尔后	爾後
税后	稅後
底板	底板
琴弦	琴絃
字面	字面
萌发	萌發
几番	幾番
弄脏	弄髒
迸发	迸發
白板	白板
金杯	金盃
精干	精幹
后进	後進
旁听	旁聽
流于	流於
发烫	發燙
女佣	女傭
后腰	後腰
银发	銀髮
板桥	板橋
注音	注音
环游	環遊
周游	周遊
账面	賬面
御用	御用
幽谷	幽谷
征订	徵訂
派系	派系
二万	二萬
壮志	壯志
发愣	發愣
历次	歷次
签收	簽收
繁复	繁複
干杯	乾杯
甄别	甄別
填表	填表
生发	生發
断面	斷面
炮台	炮臺
致词	致詞
河谷	河谷
板式	板式
郊游	郊遊
巫术	巫術
致歉	致歉
行当	行當
摆好	擺好
春游	春遊
后防	後防
当事	當事
采收	採收
发毛	發毛
咸鱼	鹹魚
天坛	天壇
后继	後繼
假面	假面
右面	右面
纸板	紙板
党纪	黨紀
斗智	鬥智
并口	並口
疑云	疑雲
白布	白布
高发	高發
蒙受	蒙受
托付	託付
复赛	複賽
截面	截面
干劲	幹勁
左面	左面
发霉	發霉
判别	判別
斗殴	鬥毆
转制	轉制
屋面	屋面
派别	派別
松柏	松柏
干笑	乾笑
当世	當世
校准	校準
顽症	頑症
心弦	心弦
后路	後路
照面	照面
抹布	抹布
吊车	吊車
才气	才氣
台历	檯曆
云朵	雲朵
光复	光復
自当	自當
精于	精於
汇演	匯演
胡扯	胡扯
别管	別管
余生	餘生
当铺	當鋪
制导	制導
党务	黨務
闲情	閒情
别来	別來
万恶	萬惡
五岳	五嶽
六万	六萬
岩浆	岩漿
弦乐	弦樂
当道	當道
摆摊	擺攤
冷面	冷面
巡游	巡遊
红云	紅雲
斗嘴	鬥嘴
咱家	咱家
不周	不周
青松	青松
云烟	雲煙
冲泡	沖泡
回府	回府
丑态	醜態
割据	割據
后轮	後輪
吊灯	吊燈
发情	發情
当空	當空
布阵	佈陣
仰面	仰面
划线	劃線
后场	後場
出丑	出醜
典当	典當
永别	永別
水表	水錶
发家	發家
阴云	陰雲
履历	履歷
标杆	標杆
相干	相干
田里	田里
简朴	簡樸
人防	人防
大个	大個
板栗	板栗
喷发	噴發
胜于	勝於
不防	不防
烛台	燭臺
谋面	謀面
布鞋	布鞋
自荐	自薦
干涩	乾澀
糊口	餬口
长于	長於
考卷	考卷
致远	致遠
游移	游移
松林	松林
牙签	牙籤
台子	檯子
万方	萬方
跳板	跳板
吞并	吞併
真个	真個
江面	江面
志气	志氣
育才	育才
后辈	後輩
防灾	防災
吊装	吊裝
保荐	保薦
云雨	雲雨
奸诈	奸詐
后脑	後腦
薄板	薄板
发飙	發飆
并联	並聯
奸细	奸細
防锈	防鏽
面食	麵食
毫发	毫髮
等闲	等閒
捉奸	捉姦
吞咽	吞嚥
母后	母后
干系	干係
五脏	五臟
浪荡	浪蕩
八万	八萬
卷曲	捲曲
扎堆	紮堆
熔岩	熔岩
回天	回天
临别	臨別
签章	簽章
护发	護髮
鬼才	鬼才
盛赞	盛讚
咸菜	鹹菜
万世	萬世
堤防	堤防
回敬	回敬
花坛	花壇
女尸	女屍
晒干	晒乾
卷子	卷子
蓬松	蓬鬆
胡椒	胡椒
电汇	電匯
引致	引致
大干	大幹
产于	產於
尸首	屍首
黑云	黑雲
西周	西周
舍身	捨身
回神	回神
冲杀	衝殺
曾于	曾於
受托	受託
画板	畫板
划船	划船
闲事	閒事
摄制	攝製
设防	設防
螺杆	螺桿
慨叹	慨嘆
加注	加註
心志	心志
竭尽	竭盡
防暴	防暴
防弹	防彈
建党	建黨
发条	發條
发包	發包
对症	對症
万全	萬全
云游	雲遊
俯冲	俯衝
购并	購併
风干	風乾
假发	假髮
刻板	刻板
党派	黨派
蒙住	蒙住
死板	死板
游标	游標
下摆	下襬
当夜	當夜
根系	根系
俘获	俘獲
勤于	勤於
论据	論據
发冷	發冷
游园	遊園
制衡	制衡
尽到	盡到
敌后	敵後
干道	幹道
回笼	回籠
书后	書後
岩壁	巖壁
斗牛	鬥牛
票面	票面
补发	補發
拮据	拮据
斗法	鬥法
刊发	刊發
夜游	夜遊
哀叹	哀嘆
烟斗	煙斗
党风	黨風
奸淫	姦淫
万幸	萬幸
幅面	幅面
复数	複數
糊弄	糊弄
万历	萬曆
困局	困局
干将	幹將
擒获	擒獲
浮游	浮游
复述	複述
里拉	里拉
布施	佈施
面皮	面皮
复明	復明
后怕	後怕
承蒙	承蒙
干咳	乾咳
防区	防區
年历	年曆
茅台	茅臺
帘子	簾子
铺面	鋪面
万民	萬民
画布	畫布
心术	心術
旁白	旁白
布展	佈展
闲散	閒散
辟谣	闢謠
脏器	臟器
发源	發源
饭局	飯局
要冲	要衝
陆游	陸游
吻别	吻別
获释	獲釋
采药	採藥
发颤	發顫
云峰	雲峰
几号	幾號
台胞	臺胞
深谷	深谷
发痒	發癢
别恋	別戀
祈愿	祈願
预后	預後
联防	聯防
调回	調回
别国	別國
舍命	捨命
采花	採花
图鉴	圖鑑
砧板	砧板
冲床	衝牀
延后	延後
勃发	勃發
只许	只許
每回	每回
纤手	纖手
阔别	闊別
腌制	醃製
尼采	尼采
发夹	髮夾
祥云	祥雲
别论	別論
烹制	烹製
当庭	當庭
回手	回手
织布	織布
闲适	閒適
得志	得志
游弋	游弋
后患	後患
幻术	幻術
岩洞	巖洞
网坛	網壇
回执	回執
表里	表裏
试制	試製
制假	製假
致信	致信
扳回	扳回
杂症	雜症
房舍	房舍
注水	注水
躯干	軀幹
晃荡	晃蕩
党史	黨史
充饥	充飢
青苔	青苔
面团	麵團
划归	劃歸
制售	製售
古板	古板
阴历	陰曆
发福	發福
划清	劃清
不才	不才
里根	里根
尿布	尿布
布条	布條
摆正	擺正
游学	遊學
御寒	禦寒
面馆	麵館
浩荡	浩蕩
党群	黨群
发奋	發奮
干瘪	乾癟
回春	回春
预制	預製
里屋	裏屋
尸身	屍身
局域	局域
防寒	防寒
未卜	未卜
防患	防患
亭台	亭臺
门帘	門簾
摆到	擺到
残局	殘局
拍板	拍板
发髻	髮髻
夸赞	誇讚
夸耀	誇耀
周长	周長
单发	單發
蒙骗	矇騙
神坛	神壇
体征	體徵
谷地	谷地
余热	餘熱
恶斗	惡鬥
泰斗	泰斗
结余	結餘
白面	白面
松绑	鬆綁
甘于	甘於
干群	幹群
往复	往復
才情	才情
才学	才學
后尘	後塵
个把	個把
松子	松子
疏于	疏於
志趣	志趣
胶布	膠布
万古	萬古
旗杆	旗杆
面熟	面熟
党课	黨課
胡言	胡言
饥荒	饑荒
课表	課表
面额	面額
摆渡	擺渡
可叹	可歎
漏斗	漏斗
领回	領回
接获	接獲
赌局	賭局
复员	復員
连杆	連桿
扎营	紮營
吊桥	吊橋
奸臣	奸臣
武斗	武鬥
布防	佈防
面人	麵人
结扎	結紮
叹服	歎服
推托	推託
挤占	擠佔
大志	大志
师表	師表
云霞	雲霞
播发	播發
挨个	挨個
摆开	擺開
坯布	坯布
露台	露臺
绒布	絨布
烫发	燙髮
单于	單于
楼板	樓板
后撤	後撤
遍历	遍歷
凭据	憑據
阳历	陽曆
表征	表徵
斗胆	斗膽
脏腑	臟腑
晾干	晾乾
七万	七萬
三回	三回
冲剂	沖劑
云梯	雲梯
受雇	受僱
周济	賙濟
致残	致殘
荡妇	蕩婦
周天	周天
同党	同黨
通鉴	通鑑
月台	月臺
冲凉	沖涼
冲劲	衝勁
局促	侷促
历数	歷數
团里	團裏
折回	折回
赛制	賽制
情面	情面
回民	回民
楼台	樓臺
疏松	疏鬆
遗愿	遺願
当口	當口
党外	黨外
万福	萬福
发迹	發跡
防癌	防癌
夙愿	夙願
包干	包乾
御医	御醫
兴叹	興嘆
党报	黨報
辟邪	辟邪
布匹	布匹
板斧	板斧
面纸	面紙
嘱托	囑託
戏台	戲臺
空余	空餘
发酸	發酸
回礼	回禮
拉杆	拉杆
邮发	郵發
须发	鬚髮
干裂	乾裂
马术	馬術
历久	歷久
复国	復國
哄笑	鬨笑
汇兑	匯兌
融汇	融匯
尽速	盡速
布告	佈告
卢布	盧布
评卷	評卷
台长	臺長
星斗	星斗
展板	展板
拂面	拂面
夹板	夾板
只消	只消
后话	後話
益发	益發
志士	志士
占星	占星
胡来	胡來
批注	批註
肯干	肯幹
坐台	坐檯
莲台	蓮臺
惜别	惜別
秒表	秒錶
党籍	黨籍
哄抬	哄擡
后援	後援
谷子	穀子
余晖	餘暉
华发	華髮
采伐	採伐
吊死	吊死
胜局	勝局
游丝	游絲
准将	准將
案卷	案卷
枝干	枝幹
后妈	後媽
苔藓	苔蘚
多才	多才
后任	後任
斗笠	斗笠
后年	後年
烧制	燒製
工党	工黨
献丑	獻醜
有才	有才
面壁	面壁
发兵	發兵
海防	海防
防霉	防霉
贴面	貼面
当朝	當朝
天干	天干
十只	十隻
咽炎	咽炎
别家	別家
布道	佈道
获选	獲選
发慌	發慌
对局	對局
冲力	衝力
复函	覆函
创制	創製
高干	高幹
自夸	自誇
冲冲	沖沖
敢当	敢當
规制	規制
冲昏	沖昏
批斗	批鬥
断后	斷後
地坛	地壇
配发	配發
面面	面面
时局	時局
松涛	松濤
尽忠	盡忠
云母	雲母
党团	黨團
文才	文才
干粉	乾粉
几亿	幾億
洗面	洗面
参赞	參贊
穷尽	窮盡
御前	御前
干尸	乾屍
麻布	麻布
东岳	東嶽
弓弦	弓弦
搅局	攪局
挽歌	輓歌
直系	直系
续签	續簽
才俊	才俊
内奸	內奸
羞于	羞於
红岩	紅巖
叶面	葉面
干戈	干戈
并拢	併攏
钟点	鐘點
丑化	醜化
重托	重託
回教	回教
党旗	黨旗
隔板	隔板
万隆	萬隆
后跟	後跟
斜面	斜面
桥面	橋面
征召	徵召
周至	周至
干草	乾草
赞颂	讚頌
周详	周詳
红布	紅布
开卷	開卷
白术	白朮
表带	錶帶
干支	干支
卷宗	卷宗
只字	隻字
航向	航向
后置	後置
回电	回電
沉郁	沉鬱
闲杂	閒雜
球面	球面
挡板	擋板
松香	松香
未几	未幾
引荐	引薦
很丑	很醜
林冲	林沖
回溯	回溯
发狠	發狠
重游	重遊
离弦	離弦
赞歌	讚歌
胡人	胡人
采写	採寫
谷类	穀類
胡杨	胡楊
下咽	下嚥
复辟	復辟
历历	歷歷
历法	曆法
奸杀	姦殺
游艺	遊藝
好斗	好鬥
采石	採石
发紫	發紫
何干	何干
美丑	美醜
纤弱	纖弱
河面	河面
年表	年表
党参	黨參
秋后	秋後
征友	徵友
余波	餘波
台地	臺地
发案	發案
发落	發落
干果	乾果
高个	高個
里间	裏間
苦干	苦幹
丑事	醜事
松木	松木
殿后	殿後
筋斗	觔斗
甘当	甘當
径向	徑向
圆周	圓周
桅杆	桅杆
垮台	垮臺
采煤	採煤
通奸	通姦
燃尽	燃盡
哄抢	哄搶
话别	話別
准星	準星
上卷	上卷
干妈	乾媽
该当	該當
作别	作別
鞋面	鞋面
稳当	穩當
停当	停當
沂蒙	沂蒙
并立	並立
阿斗	阿斗
精舍	精舍
砂岩	砂岩
面见	面見
当量	當量
交卷	交卷
嫡系	嫡系
变局	變局
山岳	山嶽
余音	餘音
纸面	紙面
强占	強佔
农舍	農舍
才思	才思
后脚	後腳
我党	我黨
甚于	甚於
万金	萬金
松紧	鬆緊
卤味	滷味
快板	快板
干巴	乾巴
胡桃	胡桃
辞别	辭別
粗布	粗布
洒洒	灑灑
偶发	偶發
此致	此致
并轨	並軌
罗布	羅布
当值	當值
久别	久別
制表	製表
码表	碼表
纤巧	纖巧
妖术	妖術
采油	採油
绝后	絕後
党费	黨費
飘洒	飄灑
光面	光面
凭吊	憑弔
摆件	擺件
干流	幹流
并州	并州
正弦	正弦
占线	佔線
万顷	萬頃
板报	板報
余力	餘力
三板	三板
蒙羞	蒙羞
游水	游水
杆子	杆子
形制	形制
求才	求才
苍松	蒼松
旅舍	旅舍
书卷	書卷
结汇	結匯
卤水	鹵水
浮夸	浮誇
两回	兩回
珠帘	珠簾
霉变	霉變
请愿	請願
幕布	幕布
丁丑	丁丑
蒙恬	蒙恬
跟斗	跟斗
致密	緻密
矢志	矢志
街面	街面
复选	複選
城防	城防
征伐	征伐
干花	乾花
当班	當班
并网	併網
奸雄	奸雄
全才	全才
别针	別針
奸计	奸計
辛丑	辛丑
扇面	扇面
华里	華里
里手	裏手
准绳	準繩
当政	當政
手板	手板
悬吊	懸吊
猛冲	猛衝
哄骗	哄騙
发运	發運
万贯	萬貫
柴胡	柴胡
铲子	鏟子
显摆	顯擺
挂面	掛麵
九万	九萬
贯注	貫注
党羽	黨羽
征讨	征討
采血	採血
腰杆	腰桿
尽欢	盡歡
奸人	奸人
致函	致函
万有	萬有
复命	覆命
空当	空當
就里	就裏
发配	發配
胡诌	胡謅
酿制	釀製
举荐	舉薦
里子	裏子
母系	母系
里弄	里弄
采掘	採掘
灶台	竈臺
拳术	拳術
方志	方誌
胡话	胡話
庄周	莊周
创面	創面
面点	麵點
布控	佈控
诀别	訣別
面盆	麵盆
明志	明志
万难	萬難
败局	敗局
钳制	鉗制
咸味	鹹味
签注	簽註
挂钟	掛鐘
稀松	稀鬆
布点	佈點
谷雨	穀雨
浇注	澆注
松口	鬆口
礼赞	禮讚
乙丑	乙丑
凝注	凝注
闲心	閒心
骑术	騎術
云贵	雲貴
跳台	跳臺
溪谷	溪谷
花布	花布
钟离	鍾離
安于	安於
长卷	長卷
无余	無餘
后起	後起
托架	托架
入云	入雲
火并	火併
交游	交遊
台联	臺聯
别称	別稱
防冻	防凍
葱郁	蔥鬱
脏乱	髒亂
支局	支局
复工	復工
雇人	僱人
剖面	剖面
发式	髮式
制革	製革
雇工	雇工
发端	發端
里海	裏海
防暑	防暑
蒙人	矇人
癸丑	癸丑
复归	復歸
泼洒	潑灑
汤面	湯麵
当差	當差
斗鸡	鬥雞
专才	專才
验尸	驗屍
采茶	採茶
尸检	屍檢
收尸	收屍
云散	雲散
采撷	採擷
糨糊	糨糊
附后	附後
公干	公幹
余味	餘味
东周	東周
优游	優遊
洒水	灑水
床板	牀板
斗艳	鬥豔
奇志	奇志
译注	譯註
诱奸	誘姦
后母	後母
拟于	擬於
偷闲	偷閒
捆扎	捆紮
语汇	語彙
制糖	製糖
注脚	註腳
余数	餘數
远游	遠遊
己丑	己丑
白干	白乾
脚板	腳板
肉松	肉鬆
剪发	剪髮
台布	檯布
械斗	械鬥
发昏	發昏
巨制	巨製
复写	複寫
炒面	炒麵
板车	板車
淳于	淳于
单干	單幹
馥郁	馥郁
咣当	咣噹
余震	餘震
切面	切面
回赠	回贈
历朝	歷朝
准头	準頭
郁结	鬱結
发还	發還
脏水	髒水
囿于	囿於
棱镜	稜鏡
偏旁	偏旁
干湿	乾溼
寒舍	寒舍
腰板	腰板
岩画	巖畫
后妃	后妃
表兄	表兄
复检	複檢
布设	佈設
周章	周章
云雀	雲雀
干瘦	乾瘦
吊唁	弔唁
防磁	防磁
舰只	艦隻
失当	失當
准尉	准尉
发胀	發脹
枪托	槍托
发令	發令
游街	遊街
云气	雲氣
斗室	斗室
干柴	乾柴
周朝	周朝
夸口	誇口
万代	萬代
停发	停發
闲钱	閒錢
乒坛	乒壇
表盘	錶盤
消闲	消閒
华表	華表
云杉	雲杉
米面	米麵
驻防	駐防
回嘴	回嘴
高云	高雲
熨斗	熨斗
亲征	親征
岩层	岩層
铁面	鐵面
蛋卷	蛋捲
英制	英制
竹签	竹籤
扎眼	扎眼
发晕	發暈
卷筒	捲筒
衬里	襯裏
旁路	旁路
悲叹	悲嘆
撤防	撤防
急症	急症
钟馗	鍾馗
制宪	制憲
发愿	發願
术科	術科
次于	次於
奸污	姦汙
秋游	秋遊
诗坛	詩壇
印鉴	印鑑
干渴	乾渴
当权	當權
遗志	遺志
收汇	收匯
头面	頭面
棉签	棉籤
中签	中籤
经卷	經卷
卤素	鹵素
余韵	餘韻
发臭	發臭
春卷	春捲
当堂	當堂
倒台	倒臺
危局	危局
愁云	愁雲
回禀	回稟
向心	向心
电杆	電杆
据闻	據聞
岩溶	岩溶
回生	回生
板油	板油
余量	餘量
余孽	餘孽
怀表	懷錶
明鉴	明鑑
脏字	髒字
编发	編發
贤才	賢才
闭卷	閉卷
县志	縣誌
伴游	伴遊
才人	才人
吁吁	吁吁
复婚	復婚
复垦	復墾
御敌	禦敵
马扎	馬紮
捧杯	捧杯
尽孝	盡孝
发奖	發獎
笔杆	筆桿
归并	歸併
轧制	軋製
身板	身板
节余	節餘
俭朴	儉樸
奸情	姦情
案板	案板
农闲	農閒
发函	發函
制伏	制伏
夸父	夸父
蛮干	蠻幹
脚面	腳面
吊环	吊環
并茂	並茂
舌苔	舌苔
摇荡	搖盪
回文	迴文
抗御	抗禦
管弦	管弦
结发	結髮
小别	小別
烧杯	燒杯
现汇	現匯
钟鼓	鐘鼓
和局	和局
吊挂	吊掛
别号	別號
后汉	後漢
回环	迴環
回师	回師
评注	評註
战云	戰雲
字汇	字彙
面巾	面巾
阐发	闡發
远志	遠志
托词	託詞
御赐	御賜
庸才	庸才
统制	統制
闲扯	閒扯
霉味	霉味
干校	幹校
余威	餘威
帝制	帝制
鬓发	鬢髮
胡琴	胡琴
老几	老幾
面筋	麵筋
碰杯	碰杯
冲毁	沖毀
余粮	餘糧
考据	考據
后手	後手
汇流	匯流
魏征	魏徵
宜于	宜於
茅舍	茅舍
脾脏	脾臟
帘幕	簾幕
赤松	赤松
发怔	發怔
回迁	回遷
扎染	紮染
还愿	還願
托人	託人
顶板	頂板
篮坛	籃壇
干贝	乾貝
干货	乾貨
台基	臺基
蓝布	藍布
游憩	遊憩
海苔	海苔
回水	回水
获罪	獲罪
当啷	噹啷
公制	公制
牌局	牌局
饥民	饑民
一准	一準
上弦	上弦
厚朴	厚朴
扼制	扼制
洒泪	灑淚
译制	譯製
赋闲	賦閒
表叔	表叔
短板	短板
终局	終局
尸骸	屍骸
画坛	畫壇
转台	轉臺
冲垮	沖垮
发汗	發汗
丑角	丑角
权术	權術
打制	打製
复线	複線
将才	將才
舍下	舍下
云锦	雲錦
设局	設局
松针	松針
回火	回火
北周	北周
喟叹	喟嘆
复利	複利
复诊	複診
占住	佔住
奸贼	奸賊
托收	託收
闲居	閒居
塔吊	塔吊
高才	高才
停摆	停擺
旧制	舊制
宏愿	宏願
手卷	手卷
丧钟	喪鐘
束发	束髮
并吞	併吞
冲服	沖服
咨文	咨文
拜别	拜別
钟摆	鐘擺
竹帘	竹簾
复学	復學
滥发	濫發
回函	回函
红松	紅松
刨冰	鉋冰
嗟叹	嗟歎
余弦	餘弦
哄然	哄然
周代	周代
请托	請託
吊床	吊牀
炒汇	炒匯
采买	採買
二板	二板
征象	徵象
角斗	角鬥
荡涤	盪滌
铲车	鏟車
蒙昧	蒙昧
棋坛	棋壇
回潮	回潮
御驾	御駕
发胶	髮膠
回返	回返
才貌	才貌
发辫	髮辮
划界	劃界
水帘	水簾
板牙	板牙
云鬓	雲鬢
砚台	硯臺
万状	萬狀
国术	國術
居里	居里
回填	回填
饥寒	飢寒
进占	進佔
致伤	致傷
谷仓	穀倉
纤柔	纖柔
蒙尘	蒙塵
发愤	發憤
周知	周知
松果	松果
吊兰	吊蘭
卜卦	卜卦
铲平	剷平
低回	低迴
近旁	近旁
垂帘	垂簾
削发	削髮
誓愿	誓願
干饭	乾飯
寓于	寓於
扣发	扣發
谱系	譜系
脑干	腦幹
蒙混	蒙混
干酪	乾酪
会签	會簽
采办	採辦
托梦	託夢
发急	發急
划拳	划拳
北岳	北嶽
据守	據守
通才	通才
复评	複評
松土	鬆土
周正	周正
咏叹	詠歎
西岳	西嶽
面糊	麵糊
岳家	岳家
别字	別字
旁系	旁系
来复	來復
承当	承當
旁门	旁門
枯干	枯乾
冲程	衝程
苦斗	苦鬥
猪舍	豬舍
回炉	回爐
回送	回送
复姓	複姓
世系	世系
各别	各別
纤毫	纖毫
辟谷	辟穀
底里	底裏
反党	反黨
向背	向背
余党	餘黨
页岩	頁岩
姜汤	薑湯
墓志	墓誌
帆板	帆板
郁积	鬱積
咽气	嚥氣
刨床	鉋牀
纤夫	縴夫
征调	徵調
松花	松花
涤荡	滌盪
父系	父系
干渠	幹渠
余兴	餘興
民防	民防
弦歌	弦歌
借据	借據
死别	死別
防老	防老
后肢	後肢
烟卷	煙捲
后娘	後娘
压板	壓板
肺脏	肺臟
鼻咽	鼻咽
枪杆	槍桿
冲积	沖積
雇请	僱請
回波	回波
胡搞	胡搞
恩准	恩准
摆谱	擺譜
冲销	沖銷
云头	雲頭
劈面	劈面
入托	入託
布谷	布穀
编后	編後
贪杯	貪杯
总后	總後
挽联	輓聯
垫板	墊板
洪钟	洪鐘
卷尺	捲尺
藏历	藏曆
编钟	編鐘
松脂	松脂
尽然	盡然
夸克	夸克
游逛	遊逛
安闲	安閒
退党	退黨
扎手	扎手
韵致	韻致
油布	油布
托孤	託孤
谜面	謎面
本愿	本願
吊钩	吊鉤
蒙语	蒙語
胡笳	胡笳
荡平	蕩平
白卷	白卷
发面	發麵
横杆	橫杆
闲书	閒書
音准	音準
图板	圖板
里脊	裏脊
无干	無干
局子	局子
鼓荡	鼓盪
三弦	三弦
词表	詞表
云图	雲圖
回纥	回紇
磨制	磨製
复现	復現
里层	裏層
万籁	萬籟
奸邪	奸邪
落发	落髮
后周	後周
嗣后	嗣後
丑行	醜行
回见	回見
艺坛	藝壇
衬布	襯布
表嫂	表嫂
舢板	舢板
党办	黨辦
蒙冤	蒙冤
雄才	雄才
山系	山系
旁证	旁證
中岳	中嶽
奸佞	奸佞
吊扇	吊扇
干菜	乾菜
才识	才識
干冰	乾冰
复职	復職
发菜	髮菜
游兴	遊興
划艇	划艇
辩才	辯才
局外	局外
轻闲	輕閒
症候	症候
胰脏	胰臟
旧历	舊曆
复验	複驗
发蓝	發藍
别传	別傳
面汤	麵湯
灯台	燈臺
花卷	花捲
台柱	臺柱
土布	土布
游医	游醫
皂角	皂角
老表	老表
苍术	蒼朮
照准	照準
后唐	後唐
发指	髮指
顺当	順當
层云	層雲
包谷	包穀
云豹	雲豹
瓦当	瓦當
西历	西曆
回锅	回鍋
儒术	儒術
后顾	後顧
叛党	叛黨
字据	字據
濒于	瀕於
发怵	發怵
拆台	拆臺
复刊	復刊
板鸭	板鴨
撞钟	撞鐘
换防	換防
塔台	塔臺
集注	集註
卤菜	滷菜
面善	面善
积郁	積鬱
冲喜	沖喜
了局	了局
光杆	光桿
霉烂	霉爛
扎针	扎針
回肠	迴腸
球台	球檯
表亲	表親
阴干	陰乾
换汇	換匯
夏历	夏曆
致哀	致哀
余暇	餘暇
邻舍	鄰舍
砂布	砂布
发妻	髮妻
被里	被裏
归向	歸向
闲气	閒氣
回绕	迴繞
花台	花臺
绑扎	綁紮
才略	才略
布帛	布帛
咸肉	鹹肉
草签	草簽
相术	相術
饥馑	饑饉
洋面	洋麵
吁请	籲請
划拉	劃拉
凉台	涼臺
摆阔	擺闊
占先	佔先
松脆	鬆脆
油松	油松
提干	提幹
拳坛	拳壇
特准	特准
吊索	吊索
表语	表語
末后	末後
挽手	挽手
棱柱	稜柱
万端	萬端
相面	相面
叹惜	嘆惜
格致	格致
羽坛	羽壇
起吊	起吊
罗致	羅致
朋党	朋黨
复课	復課
谷草	穀草
基干	基幹
准保	準保
姜黄	薑黃
复信	覆信
当令	當令
发轫	發軔
表字	表字
发祥	發祥
卜筮	卜筮
霉气	霉氣
昆布	昆布
土制	土製
续弦	續絃
称愿	稱願
哗变	譁變
游廊	遊廊
纤毛	纖毛
丧志	喪志
萦回	縈迴
挟制	挾制
钻杆	鑽桿
方术	方術
风致	風致
几折	幾折
复音	複音
发蒙	發矇
洒扫	灑掃
划桨	划槳
奸猾	奸猾
岳丈	岳丈
旁支	旁支
松劲	鬆勁
党龄	黨齡
松仁	松仁
布头	布頭
复旧	復舊
系谱	系譜
杆秤	桿秤
蒙药	蒙藥
客舍	客舍
回门	回門
圆台	圓臺
板壁	板壁
病征	病徵
余烬	餘燼
风发	風發
防旱	房旱
蒙族	蒙族
脚注	腳註
党魁	黨魁
党徽	黨徽
蒙难	蒙難
蓊郁	蓊鬱
镜台	鏡臺
发薪	發薪
相托	相託
复会	復會
座钟	座鐘
谁个	誰個
干冷	乾冷
云汉	雲漢
胡麻	胡麻
颂赞	頌讚
全托	全託
发榜	發榜
假托	假託
被面	被面
余毒	餘毒
毛布	毛布
净尽	淨盡
丑时	丑時
关防	關防
舒卷	舒捲
传布	傳佈
竹板	竹板
复叶	複葉
板条	板條
彤云	彤雲
台盟	臺盟
谷粒	穀粒
表土	表土
朴质	樸質
干结	乾結
帘布	帘布
银杯	銀杯
鸡奸	雞姦
党徒	黨徒
别绪	別緒
苍郁	蒼鬱
锋面	鋒面
发痴	發癡
折冲	折衝
波谷	波谷
才力	才力
遮丑	遮醜
锄奸	鋤奸
表舅	表舅
流荡	流蕩
复种	複種
后嗣	後嗣
裱糊	裱糊
刨花	鉋花
吊桶	吊桶
搓板	搓板
后梁	後梁
量杯	量杯
素朴	素樸
印台	印臺
虏获	虜獲
起获	起獲
复句	複句
党纲	黨綱
猎获	獵獲
征候	徵候
朴拙	樸拙
丝弦	絲絃
布店	布店
防地	防地
棱锥	稜錐
历书	曆書
旁注	旁註
杯葛	杯葛
腥膻	腥羶
面塑	麵塑
丑剧	醜劇
复壮	復壯
墨斗	墨斗
发蜡	髮蠟
奸险	奸險
征购	徵購
饥肠	飢腸
克复	克復
夏布	夏布
台步	臺步
饯别	餞別
京胡	京胡
中局	中局
龙钟	龍鍾
游伴	遊伴
帮闲	幫閑
余缺	餘缺
台秤	臺秤
摆子	擺子
征募	徵募
闲荡	閒蕩
工余	工餘
复眼	複眼
数制	數制
熏制	熏製
面洽	面洽
系念	繫念
台属	臺屬
付托	付託
征尘	征塵
腹面	腹面
日托	日託
表针	錶針
面谢	面謝
征发	徵發
币制	幣制
赞语	讚語
冬闲	冬閒
吊丧	弔喪
锅台	鍋臺
阴面	陰面
佣工	傭工
赞佩	讚佩
整党	整黨
向隅	向隅
撑杆	撐杆
荐举	薦舉
斗方	斗方
皇历	皇曆
细布	細布
丢丑	丟醜
闲职	閒職
侨汇	僑匯
雇农	雇農
泳坛	泳壇
采种	採種
卜辞	卜辭
幽咽	幽咽
缓征	緩徵
复视	複視
修面	修面
炉台	爐臺
套汇	套匯
卤化	鹵化
扎花	扎花
逛荡	逛蕩
赏鉴	賞鑑
握别	握別
信汇	信匯
葛布	葛布
快当	快當
表记	表記
冲蚀	沖蝕
凹面	凹面
赠别	贈別
表链	錶鏈
系词	系詞
卜居	卜居
发糕	發糕
实据	實據
浮荡	浮蕩
屈才	屈才
墩布	墩布
砾岩	礫岩
船台	船臺
御侮	禦侮
拿获	拿獲
干才	幹才
表册	表冊
后灯	後燈
职别	職別
皂化	皂化
抽咽	抽咽
曲霉	麴黴
市制	市制
四旁	四旁
花托	花托
发排	發排
积云	積雲
大别	大別
晤面	晤面
晒台	晒臺
卷舌	捲舌
笃志	篤志
虚夸	虛誇
铺板	鋪板
当票	當票
占卦	占卦
胡蜂	胡蜂
巧干	巧幹
刨刀	鉋刀
称叹	稱歎
浮面	浮面
云量	雲量
征聘	徵聘
岩盐	岩鹽
注文	註文
塔钟	塔鐘
旁及	旁及
皂白	皁白
板胡	板胡
刨根	刨根
挂表	掛錶
硬面	硬麵
秤杆	秤桿
长霉	長霉
岩心	岩心
采录	採錄
回拜	回拜
移防	移防
预卜	預卜
调防	調防
闾里	閭里
斗车	斗車
板刷	板刷
盐卤	鹽滷
卷须	捲鬚
抓周	抓週
拍发	拍發
冲决	沖決
表尺	表尺
乡愿	鄉愿
胡适	胡適
科系	科系
党部	黨部
限于	限於
评鉴	評鑑
台东	臺東
海淀	海淀
干城	干城
台州	台州
回目	回目
面的	麵的
获致	獲致
松江	松江
异于	異於
举发	舉發
个展	個展
武松	武松
合于	合於
告发	告發
据以	據以
后羿	后羿
几万	幾萬
盗采	盜採
仅只	僅只
斩获	斬獲
求签	求籤
向学	向學
寻获	尋獲
个中	個中
摆荡	擺盪
台中	臺中
高胡	高胡
诉愿	訴願
立于	立於
后半	後半
党国	黨國
咸丰	咸豐
台南	臺南
回航	回航
世局	世局
片岩	片岩
有致	有致
近于	近於
棋局	棋局
有闲	有閒
阿里	阿里
的当	的當
当是	當是
惯于	慣於
失准	失準
据实	據實
采信	採信
拾获	拾獲
万国	萬國
神游	神遊
游魂	游魂
天台	天臺
肉干	肉乾
周会	週會
余光	餘光
复本	複本
划一	劃一
了当	了當
于今	於今
回跌	回跌
才具	才具
朴直	樸直
发抒	發抒
斗六	斗六
稽征	稽徵
情致	情致
内斗	內鬥
上回	上回
殷鉴	殷鑑
签筒	籤筒
荡然	蕩然
理当	理當
空荡	空蕩
改回	改回
干政	干政
挹注	挹注
转系	轉系
窃据	竊據
个位	個位
戒坛	戒壇
公余	公餘
缉获	緝獲
党证	黨證
密云	密雲
后仰	後仰
自个	自個
后心	後心
查表	查表
停板	停板
品系	品系
击发	擊發
庶几	庶幾
馆舍	館舍
发闷	發悶
进制	進制
才分	才分
回游	迴游
陈尸	陳屍
帮佣	幫傭
回历	回曆
余年	餘年
余温	餘溫
余钱	餘錢
转注	轉註
猝发	猝發
拨发	撥發
锅铲	鍋鏟
刨子	鉋子
吊孝	弔孝
鉴戒	鑑戒
匡复	匡復
签条	籤條
邮汇	郵匯
雨布	雨布
皂隶	皁隸
纤绳	縴繩
寿面	壽麵
划子	划子
诱致	誘致
意表	意表
征引	徵引
咸阳	咸陽
丰台	豐臺
徐汇	徐匯
点钟	點鐘
始于	始於
十里	十里
余姚	餘姚
松原	松原
三里	三里
龙岩	龍巖
仪征	儀徵
余杭	餘杭
新余	新余
只可	只可
台山	台山
周口	周口
南汇	南匯
三台	三台
云浮	雲浮
发水	發水
面交	面交
力荐	力薦
五里	五里
台本	臺本
咸宁	咸寧
里带	裏帶
尚志	尚志
向日	向日
十回	十回
谷歌	穀歌
和面	和麵
东台	東臺
金坛	金壇
钟山	鍾山
尽可	盡可
一表	一表
路向	路向
个旧	箇舊
流布	流佈
凯里	凱里
姜堰	姜堰
一里	一里
发傻	發傻
发嗲	發嗲
二里	二里
壹万	壹萬
当阳	當陽
万宁	萬寧
暗里	暗裏
别是	別是
模棱	模稜
下卷	下卷
下弦	下弦
钟祥	鐘祥
灵台	靈臺
南岳	南嶽
口杯	口杯
慎防	慎防
准点	準點
乏术	乏術
咸蛋	鹹蛋
大面	大面
九台	九臺
签单	簽單
干爽	乾爽
光板	光板
面砖	面磚
承制	承製
黑布	黑布
后补	後補
家丑	家醜
防除	防除
发网	髮網
后文	後文
得闲	得閒
明里	明裏
点发	點發
后身	後身
回书	回書
定当	定當
板结	板結
万源	萬源
个例	個例
万死	萬死
过当	過當
后金	後金
纤长	纖長
精当	精當
发报	發報
后日	後日
松滋	松滋
洒家	洒家
后学	後學
冲顶	衝頂
纤尘	纖塵
游程	遊程
旁骛	旁騖
翻卷	翻捲
贵干	貴幹
坑蒙	坑矇
保准	保準
冲量	衝量
托生	託生
纤瘦	纖瘦
御笔	御筆
药皂	藥皂
乡党	鄉黨
走台	走臺
冲模	衝模
工于	工於
回还	迴還
盯防	盯防
旁落	旁落
卷纸	捲紙
后福	後福
咸淡	鹹淡
游方	遊方
面呈	面呈
哄人	哄人
协防	協防
发虚	發虛
断弦	斷絃
归回	歸回
翻斗	翻斗
后尾	後尾
胡吹	胡吹
鲜于	鮮於
回单	回單
回鹘	回鶻
余悸	餘悸
校注	校註
果干	果乾
面生	面生
发身	發身
向火	向火
注疏	註疏
汇展	匯展
开台	開臺
冲澡	沖澡
布网	佈網
于思	于思
并流	並流
党项	党項
大冲	大衝
灌制	灌製
南斗	南斗
拖布	拖布
穆棱	穆棱
杆塔	桿塔
薄面	薄面
堪布	堪布
几曾	幾曾
后效	後效
鸿蒙	鴻蒙
数表	數表
扎啤	扎啤
摆桌	擺桌
改签	改簽
并蒂	並蒂
头里	頭裏
手松	手鬆
帅才	帥才
复转	復轉
寇准	寇準
面首	面首
膻中	膻中
应制	應制
漂游	漂游
复业	復業
莪术	莪朮
别情	別情
明面	明面
残卷	殘卷
硃卷	硃卷
庆历	慶曆
阳面	陽面
回涨	回漲
从征	從征
米制	米制
衣摆	衣襬
后晋	後晉
叹号	歎號
笺注	箋註
几案	几案
拾万	拾萬
身历	身歷
划价	劃價
吊线	吊線
洄游	洄游
田舍	田舍
蒙学	蒙學
岩羊	岩羊
工致	工緻
吊扣	吊扣
里巷	里巷
纤小	纖小
蒙文	蒙文
汇费	匯費
后步	後步
问卜	問卜
开蒙	開蒙
发窘	發窘
愿心	願心
发物	發物
发丧	發喪
起复	起復
失据	失據
叁万	叄萬
板擦	板擦
后舱	後艙
作准	作準
蚁后	蟻后
卤鸡	滷雞
小注	小註
哄闹	鬨鬧
吃准	吃準
音系	音系
表功	表功
芦荡	蘆蕩
别子	別子
口占	口占
照发	照發
走板	走板
干犯	干犯
干连	干連
手面	手面
干股	乾股
斗子	斗子
烫面	燙麵
卷帙	卷帙
云崖	雲崖
藏奸	藏奸
关里	關裏
童蒙	童蒙
辖制	轄制
香干	香乾
浪游	浪游
鱼松	魚鬆
井台	井臺
扑棱	撲棱
宽余	寬餘
条几	條几
咸盐	鹹鹽
尽自	儘自
冲要	衝要
回空	回空
并案	併案
朴刀	朴刀
黏糊	黏糊
遂愿	遂願
允准	允准
准信	準信
波荡	波盪
托庇	託庇
后影	後影
酥松	酥鬆
皂荚	皂莢
布菜	佈菜
干仗	幹仗
棋布	棋佈
向使	向使
笔致	筆致
板眼	板眼
定准	定準
伍万	伍萬
江防	江防
汇水	匯水
郁热	鬱熱
干嚎	乾嚎
死局	死局
叹赏	歎賞
拉纤	拉縴
伪托	僞託
丑话	醜話
回青	回青
大辟	大辟
霉天	霉天
河防	河防
席面	席面
后父	後父
闲空	閒空
旁批	旁批
余风	餘風
贰万	貳萬
旌表	旌表
痹症	痹症
死面	死麵
丑星	醜星
单弦	單弦
阉党	閹黨
别史	別史
竹布	竹布
诗余	詩餘
后景	後景
托名	託名
宦游	宦游
蓄发	蓄髮
板瓦	板瓦
摆列	擺列
托病	託病
叹词	歎詞
展卷	展卷
并驱	並驅
面陈	面陳
漆布	漆布
复交	復交
嘴松	嘴鬆
发市	發市
回条	回條
抽斗	抽斗
露丑	露醜
挺尸	挺屍
转托	轉託
干馏	乾餾
确当	確當
接防	接防
旁顾	旁顧
坍台	坍臺
声旁	聲旁
赞礼	贊禮
夸饰	誇飾
留别	留別
蒙医	蒙醫
诈尸	詐屍
定弦	定弦
卷次	卷次
防凌	防凌
回请	回請
棱子	稜子
周缘	周緣
题签	題簽
碑志	碑誌
姨表	姨表
跑表	跑錶
发凡	發凡
回口	回口
吊祭	弔祭
朴学	樸學
浑朴	渾樸
吁求	籲求
台扇	臺扇
敌台	敵臺
准定	准定
墓表	墓表
逃汇	逃匯
党锢	黨錮
诚朴	誠樸
夸示	誇示
守制	守制
透辟	透闢
纤度	纖度
板荡	板蕩
面商	面商
削面	削麵
低云	低雲
姑表	姑表
矜夸	矜誇
万俟	万俟
檀板	檀板
闲章	閒章
肆万	肆萬
余切	餘切
欺蒙	欺蒙
压台	壓臺
压卷	壓卷
愚蒙	愚蒙
回翔	迴翔
伴当	伴當
陆万	陸萬
贪占	貪佔
签押	籤押
发付	發付
台钟	臺鐘
长局	長局
奸宄	奸宄
刊布	刊佈
屯扎	屯紮
苫布	苫布
摆钟	擺鐘
松心	鬆心
湘帘	湘簾
表侄	表姪
御批	御批
巉岩	巉巖
调干	調幹
洋布	洋布
梓里	梓里
素志	素志
奸徒	奸徒
契据	契據
抻面	抻麵
编余	編餘
台笔	臺筆
骗汇	騙匯
相里	相里
悠荡	悠蕩
回驳	回駁
志哀	誌哀
托故	託故
刨工	鉋工
占梦	占夢
斗渠	斗渠
拖斗	拖斗
票汇	票匯
蜡台	蠟臺
绉布	縐布
冲犯	衝犯
霉雨	霉雨
旁出	旁出
提制	提製
板实	板實
郁悒	鬱悒
罄尽	罄盡
调卷	調卷
丑类	醜類
板鼓	板鼓
开吊	開弔
表姑	表姑
局骗	局騙
捌万	捌萬
余存	餘存
板滞	板滯
夹注	夾註
歪才	歪才
回改	回改
壁钟	壁鐘
发横	發橫
畚斗	畚斗
战表	戰表
夺杯	奪盃
后爹	後爹
托子	托子
干啤	乾啤
舍间	舍間
发蔫	發蔫
郁愤	鬱憤
发懒	發懶
蒙馆	蒙館
允当	允當
抽闲	抽閒
胡搅	胡攪
叙别	敘別
斗筲	斗筲
私党	私黨
准谱	準譜
后晌	後晌
后襟	後襟
汇拢	匯攏
悲咽	悲咽
斗牌	鬥牌
台甫	台甫
发困	發困
形旁	形旁
净余	淨餘
信据	信據
向例	向例
棱台	稜臺
干亲	乾親
谱表	譜表
浮吊	浮吊
封里	封裏
胡匪	鬍匪
余角	餘角
防涝	防澇
胎发	胎髮
风斗	風斗
门斗	門斗
回护	迴護
龟鉴	龜鑑
糊墙	糊牆
党棍	黨棍
裁并	裁併
朴厚	樸厚
密致	密緻
游禽	游禽
游乡	遊鄉
柒万	柒萬
托疾	託疾
电钟	電鐘
舍亲	舍親
呼台	呼臺
规复	規復
戽斗	戽斗
赎当	贖當
朴硝	朴硝
玖万	玖萬
诠注	詮註
当腰	當腰
哄传	哄傳
钻台	鑽臺
智术	智術
干谒	干謁
秕谷	秕穀
死症	死症
流别	流別
征实	徵實
吹台	吹臺
圭表	圭表
苇荡	葦蕩
捍御	捍禦
并骨	併骨
斗眼	鬥眼
系恋	繫戀
台鉴	台鑒
别嘴	彆嘴
欺哄	欺哄
云锣	雲鑼
荐引	薦引
松嘴	鬆嘴
准话	準話
冲账	沖賬
觌面	覿面
蒙垢	蒙垢
笆斗	笆斗
松气	松氣
望板	望板
袭占	襲佔
哄逗	哄逗
蛏干	蟶乾
丑史	醜史
卷逃	捲逃
干急	乾急
试表	試表
纤悉	纖悉
回禄	回祿
尸位	尸位
吊楼	吊樓
挂斗	掛斗
卤虾	滷蝦
摸准	摸準
干硬	乾硬
耍奸	耍奸
冶游	冶遊
裹扎	裹紮
酒帘	酒帘
塌台	塌臺
母钟	母鐘
瞒哄	瞞哄
游仙	遊仙
干薪	乾薪
脏土	髒土
草荐	草荐
后账	後賬
占课	占課
旷荡	曠蕩
防特	防特
吞占	吞佔
历陈	歷陳
叹羡	歎羨
晾台	晾臺
盲干	盲幹
咽头	咽頭
蒙哄	蒙哄
征聊	徵聊
倒汇	倒匯
唾余	唾餘
发痧	發痧
干碍	干礙
眷注	眷注
险症	險症
尸蜡	屍蠟
初愿	初願
披卷	披卷
押当	押當
现局	現局
党阀	黨閥
吊铺	吊鋪
靶台	靶臺
台驾	台駕
冷布	冷布
汇映	匯映
面叙	面敘
丑诋	醜詆
弥蒙	彌蒙
吊窗	吊窗
课卷	課卷
蓄志	蓄志
朴陋	樸陋
搌布	搌布
佣钱	佣錢
卜课	卜課
返防	返防
茶卤	茶滷
夸嘴	誇嘴
央托	央託
托熟	託熟
惬当	愜當
拘板	拘板
暌别	暌別
抄获	抄獲
吊卷	弔卷
子弦	子弦
表报	表報
松快	松快
簸荡	簸盪
中卷	中卷
两里	兩里
白面	白麵
编制	編製
不准	不準
布景	布景
创制	創制
村里	村里
定制	定制
定准	定准
复音	覆音
复合	複合
改制	改製
海里	海裏
机制	機製
加注	加注
姜黄	姜黃
金杯	金杯
冷面	冷麵
面盆	面盆
市制	市製
收获	收穫
四周	四週
台风	臺風
天台	天台
下面	下麵
压制	壓製
银杯	銀盃
郁郁	郁郁
制表	製錶
注音	註音
自制	自制
一周	一周
回复	回復
冲犯	沖犯
举杯	舉盃
汇编	匯編
蒙蒙	濛濛
编发	編髮
仪表	儀錶
可叹	可嘆
不干	不幹
小丑	小丑
才能	才能
䍀缕	繿縷
咱们	偺們
咱俩	偺倆
秋千	鞦韆
汇丰	滙豐
并没有	並沒有
并不是	並不是
准确性	準確性
台北市	臺北市
回收站	回收站
干什么	幹什麽
只不过	只不過
据了解	據了解
个性化	個性化
历史上	歷史上
防火墙	防火牆
万年历	萬年曆
致力于	致力於
当事人	當事人
台式机	臺式機
游戏机	遊戲機
尽可能	盡可能
制造商	製造商
局域网	局域網
云南省	雲南省
制造业	製造業
几个月	幾個月
表现出	表現出
发动机	發動機
发布会	發佈會
复印机	複印機
发言人	發言人
准备好	準備好
胡锦涛	胡錦濤
表面上	表面上
注意力	注意力
面对面	面對面
据介绍	據介紹
几年来	幾年來
游泳池	游泳池
几分钟	幾分鐘
志愿者	志願者
面临着	面臨著
发信人	發信人
注册码	註冊碼
汇款单	匯款單
赞助商	贊助商
舍不得	捨不得
几十年	幾十年
发展观	發展觀
发烧友	發燒友
注册表	註冊表
几年前	幾年前
据统计	據統計
复印件	複印件
几句话	幾句話
占有率	佔有率
发起人	發起人
回过头	回過頭
向日葵	向日葵
面包车	麵包車
发脾气	發脾氣
党中央	黨中央
并发症	併發症
历史性	歷史性
台湾省	臺灣省
制作人	製作人
发电机	發電機
复杂性	複雜性
周恩来	周恩來
胡萝卜	胡蘿蔔
注册版	註冊版
局限性	侷限性
据报道	據報道
当回事	當回事
症候群	症候群
几十个	幾十個
党组织	黨組織
党支部	黨支部
制造厂	製造廠
回忆录	回憶錄
尽全力	盡全力
局限于	侷限於
干细胞	幹細胞
发展史	發展史
后遗症	後遺症
里程碑	里程碑
布拉格	布拉格
历史学	歷史學
游乐园	遊樂園
周期性	週期性
冲击波	衝擊波
当地人	當地人
获得者	獲得者
防盗门	防盜門
发言权	發言權
几方面	幾方面
发生器	發生器
郁金香	鬱金香
制度化	制度化
发病率	發病率
游乐场	遊樂場
冲击力	衝擊力
发件箱	發件箱
防城港	防城港
回报率	回報率
系统性	系統性
发电厂	發電廠
准考证	准考證
制片厂	製片廠
后视镜	後視鏡
制片人	製片人
旁观者	旁觀者
松花江	松花江
只限于	只限於
表达式	表達式
万花筒	萬花筒
万用表	萬用錶
游击队	游擊隊
面面观	面面觀
复选框	複選框
表现力	表現力
准确率	準確率
党代会	黨代會
据调查	據調查
纤维素	纖維素
发行量	發行量
复读机	複讀機
发源地	發源地
于是乎	於是乎
制高点	制高點
个体户	個體戶
占便宜	佔便宜
游戏类	遊戲類
板着脸	板著臉
发祥地	發祥地
占上风	佔上風
冲锋枪	衝鋒槍
钟点工	鐘點工
准备金	準備金
舍利子	舍利子
占优势	佔優勢
制药厂	制藥廠
表决权	表決權
划时代	劃時代
系统化	系統化
松江区	松江區
获奖者	獲獎者
防腐剂	防腐劑
局外人	局外人
周总理	周總理
复杂化	複雜化
万分之	萬分之
回车键	回車鍵
万圣节	萬聖節
发展商	發展商
丑小鸭	醜小鴨
干燥机	乾燥機
复活节	復活節
后勤部	後勤部
蒙古族	蒙古族
发件人	發件人
党总支	黨總支
游击战	游擊戰
万事通	萬事通
回音壁	回音壁
后悔药	後悔藥
胡志明	胡志明
托儿所	託兒所
蒙太奇	蒙太奇
游泳馆	游泳館
胡耀邦	胡耀邦
布隆迪	布隆迪
纤维板	纖維板
回头客	回頭客
发电量	發電量
里斯本	里斯本
几内亚	幾內亞
制动器	制動器
据估计	據估計
向前看	向前看
系列化	系列化
注射器	注射器
哗啦啦	嘩啦啦
游戏厅	遊戲廳
赞比亚	贊比亞
制衣厂	制衣廠
防疫站	防疫站
万维网	萬維網
发行价	發行價
后脑勺	後腦勺
向心力	向心力
回归线	回歸線
制成品	製成品
向前进	向前進
致命伤	致命傷
历史剧	歷史劇
发热量	發熱量
汇报会	匯報會
后半夜	後半夜
致癌物	致癌物
发明家	發明家
回头率	回頭率
脏兮兮	髒兮兮
党代表	黨代表
发明者	發明者
台湾岛	臺灣島
斗牛士	鬥牛士
历史系	歷史系
发神经	發神經
岳阳楼	岳陽樓
板蓝根	板藍根
表面化	表面化
回收率	回收率
赞成票	贊成票
表彰会	表彰會
复制品	複製品
注射剂	注射劑
表面积	表面積
干扰素	干擾素
发射机	發射機
蒙蒙亮	矇矇亮
赞美诗	讚美詩
干燥剂	乾燥劑
占有量	佔有量
防护林	防護林
致病菌	致病菌
防空洞	防空洞
发高烧	發高燒
发电站	發電站
万年青	萬年青
布谷鸟	布穀鳥
摆地摊	擺地攤
卷心菜	捲心菜
干燥箱	乾燥箱
干电池	乾電池
几何学	幾何學
刨花板	鉋花板
布依族	布依族
周转率	周轉率
防波堤	防波堤
防卫厅	防衛廳
卷帘门	捲簾門
复习题	複習題
几何体	幾何體
回头路	回頭路
党政军	黨政軍
防弹衣	防彈衣
回顾展	回顧展
谷氨酸	穀氨酸
蒙汗药	蒙汗藥
糊涂账	糊塗賬
卜算子	卜算子
几天来	幾天來
历史观	歷史觀
发货人	發貨人
蒙古包	蒙古包
发表会	發表會
采购员	採購員
丑八怪	醜八怪
钟鼓楼	鐘鼓樓
姜子牙	姜子牙
卤化物	鹵化物
表演赛	表演賽
向钱看	向錢看
后汉书	後漢書
干巴巴	乾巴巴
扎伊尔	扎伊爾
划不来	划不來
复写纸	複寫紙
卷扬机	捲揚機
干着急	乾著急
回形针	回形針
致公党	致公黨
托拉斯	托拉斯
当家人	當家人
雇佣军	僱傭軍
周作人	周作人
回马枪	回馬槍
后空翻	後空翻
吊脚楼	吊腳樓
划得来	划得來
防冻剂	防凍劑
面巾纸	面巾紙
御林军	御林軍
干休所	幹休所
发芽率	發芽率
后备军	後備軍
制空权	制空權
松紧带	鬆緊帶
万金油	萬金油
几代人	幾代人
周转量	周轉量
几点钟	幾點鐘
鉴定书	鑑定書
闲工夫	閒工夫
淀粉酶	澱粉酶
闲不住	閒不住
糊涂虫	糊塗蟲
鉴定人	鑑定人
干瞪眼	乾瞪眼
台球桌	檯球桌
干燥器	乾燥器
布朗族	布朗族
采石场	採石場
万户侯	萬戶侯
后坐力	後坐力
并蒂莲	並蒂蓮
回教徒	回教徒
鉴定会	鑑定會
发酒疯	發酒瘋
摆架子	擺架子
防锈油	防鏽油
防守型	防守型
钟乳石	鐘乳石
扎兰屯	扎蘭屯
鉴赏力	鑑賞力
后半部	後半部
防老剂	防老劑
周转金	周轉金
弦乐器	弦樂器
周口店	周口店
万能胶	萬能膠
准确度	準確度
党委会	黨委會
志愿书	志願書
松节油	松節油
别动队	別動隊
面神经	面神經
发案率	發案率
发令枪	發令槍
志愿兵	志願兵
卷铺盖	捲鋪蓋
咸鸭蛋	鹹鴨蛋
占领区	佔領區
游园会	遊園會
尽义务	盡義務
防洪堤	防洪堤
发射极	發射極
防空壕	防空壕
面包圈	麵包圈
吊胃口	吊胃口
局内人	局內人
当权派	當權派
占领军	佔領軍
制海权	制海權
霉干菜	霉乾菜
占位符	佔位符
万言书	萬言書
回归年	回歸年
周邦彦	周邦彥
表演唱	表演唱
杯中物	杯中物
斗争性	鬥爭性
发刊词	發刊詞
回旋曲	迴旋曲
游泳裤	游泳褲
复合词	複合詞
台柱子	臺柱子
旁听生	旁聽生
夸海口	誇海口
周树人	周樹人
表面性	表面性
采茶戏	採茶戲
发洋财	發洋財
采桑子	採桑子
表面光	表面光
发报机	發報機
防风林	防風林
托老所	託老所
摆事实	擺事實
摆擂台	擺擂臺
发酵酒	發酵酒
游离态	游離態
尽人事	盡人事
周期律	週期律
表土层	表土層
占星术	占星術
吊嗓子	吊嗓子
发货方	發貨方
回文诗	迴文詩
干打垒	乾打壘
布拉吉	布拉吉
钟鼎文	鐘鼎文
冲击机	衝擊機
后半天	後半天
里外里	裏外裏
云片糕	雲片糕
游艺会	遊藝會
洒狗血	灑狗血
托人情	託人情
摆摊子	擺攤子
表侄女	表姪女
游仙诗	遊仙詩
斗心眼	鬥心眼
发语词	發語詞
吊膀子	吊膀子
弦切角	弦切角
复辅音	複輔音
铲土机	鏟土機
摆门面	擺門面
托门子	託門子
铲运车	鏟運車
防沙林	防沙林
据了解	據瞭解
联系人	聯繫人
一个人	一個人
数据库	數據庫
内蒙古	內蒙古
一个月	一個月
每个人	每個人
一系列	一系列
下划线	下劃線
开发商	開發商
开发区	開發區
海淀区	海淀區
三个月	三個月
摩托车	摩托車
不愿意	不願意
相当于	相當於
艺术品	藝術品
一个个	一個個
连云港	連雲港
玩游戏	玩遊戲
这几天	這幾天
真面目	真面目
控制器	控制器
标准化	標準化
艺术家	藝術家
前几天	前幾天
代表性	代表性
风向标	風向標
近几年	近幾年
麦当劳	麥當勞
本系统	本系統
大面积	大面積
旅游局	旅遊局
心脏病	心臟病
技术部	技術部
标志着	標誌著
每个月	每個月
杂志社	雜誌社
数据线	數據線
关系到	關係到
好几个	好幾個
代表作	代表作
圣斗士	聖鬥士
市面上	市面上
新发现	新發現
方向盘	方向盤
副局长	副局長
同志们	同志們
倾向于	傾向於
丰台区	豐臺區
根据地	根據地
大发展	大發展
总面积	總面積
上个月	上個月
出发点	出發點
代表团	代表團
好几次	好幾次
战斗力	戰鬥力
福布斯	福布斯
龙卷风	龍捲風
新局面	新局面
批发商	批發商
新发展	新發展
控制台	控制臺
风云榜	風雲榜
强制性	強制性
旅游业	旅遊業
批发价	批發價
徐汇区	徐匯區
艺术节	藝術節
战斗机	戰鬥機
新干线	新幹線
桌面上	桌面上
空荡荡	空蕩蕩
西游记	西遊記
文汇报	文匯報
技术员	技術員
方向性	方向性
研制出	研製出
分布式	分佈式
美术馆	美術館
技术性	技術性
一个劲	一個勁
一致性	一致性
千里马	千里馬
国防部	國防部
见面会	見面會
心里话	心裏話
旅游区	旅遊區
代表处	代表處
旅游者	旅遊者
白云区	白雲區
乌托邦	烏托邦
特别要	特別要
老干部	老幹部
下个月	下個月
老板娘	老闆娘
魔术师	魔術師
标准件	標準件
有别于	有別於
乳制品	乳製品
关系人	關係人
读后感	讀後感
学术界	學術界
那当然	那當然
不干胶	不乾膠
豆制品	豆製品
青霉素	青黴素
委托书	委託書
阿里山	阿里山
这几年	這幾年
洗发水	洗髮水
想当年	想當年
象征性	象徵性
新台币	新臺幣
委托人	委託人
艺术团	藝術團
气冲冲	氣沖沖
五台山	五臺山
北斗星	北斗星
意向书	意向書
平面图	平面圖
有志于	有志於
村干部	村幹部
不发达	不發達
子系统	子系統
开发部	開發部
外向型	外向型
艺术性	藝術性
城里人	城裏人
想当然	想當然
抗干扰	抗干擾
爱面子	愛面子
六个月	六個月
错别字	錯別字
突发性	突發性
手术室	手術室
爆发力	爆發力
一个样	一個樣
限制级	限制級
肉制品	肉製品
给面子	給面子
密云县	密雲縣
擂台赛	擂臺賽
样板间	樣板間
死胡同	死衚衕
缓冲区	緩衝區
莫扎特	莫扎特
歇后语	歇後語
艺术馆	藝術館
全面性	全面性
忧郁症	憂鬱症
理发师	理髮師
法制化	法制化
消防队	消防隊
兴冲冲	興沖沖
美术家	美術家
关系网	關係網
黑板报	黑板報
旅游团	旅遊團
限制性	限制性
奶制品	奶製品
麦当娜	麥當娜
管弦乐	管弦樂
七台河	七臺河
大致上	大致上
代表队	代表隊
白云山	白雲山
徐志摩	徐志摩
振荡器	振盪器
原发性	原發性
抑制剂	抑制劑
明摆着	明擺著
南汇区	南匯區
吉布提	吉布提
舞台剧	舞臺劇
艺术界	藝術界
暴发户	暴發戶
观后感	觀後感
理发店	理髮店
消防车	消防車
大胡子	大鬍子
两回事	兩回事
旅游车	旅遊車
脚后跟	腳後跟
烘干机	烘乾機
等于零	等於零
武当山	武當山
乌干达	烏干達
数据流	數據流
计划外	計劃外
全局性	全局性
标准时	標準時
灰蒙蒙	灰濛濛
艺术照	藝術照
倾向性	傾向性
大个子	大個子
响当当	響噹噹
上台阶	上臺階
多面手	多面手
千里眼	千里眼
始发站	始發站
总干事	總幹事
蒸发器	蒸發器
要面子	要面子
走后门	走後門
批发部	批發部
角斗士	角鬥士
无党派	無黨派
碳纤维	碳纖維
出发地	出發地
正当时	正當時
计划内	計劃內
手术台	手術臺
挥发性	揮發性
咋回事	咋回事
高个子	高個子
计划性	計劃性
自发性	自發性
报复性	報復性
咏叹调	詠歎調
地表水	地表水
学术性	學術性
多发性	多發性
塔里木	塔里木
缓冲器	緩衝器
见面礼	見面禮
墓志铭	墓誌銘
喀布尔	喀布爾
鼻咽癌	鼻咽癌
肥皂剧	肥皂劇
雁荡山	雁蕩山
大别山	大別山
手术刀	手術刀
水帘洞	水簾洞
多发病	多發病
罗布泊	羅布泊
马后炮	馬後炮
触发器	觸發器
一回事	一回事
国防军	國防軍
校党委	校黨委
班干部	班幹部
两面性	兩面性
前几年	前幾年
双周刊	雙週刊
红霉素	紅黴素
方面军	方面軍
肥皂泡	肥皂泡
乱哄哄	亂哄哄
不尽然	不盡然
启发性	啟發性
联系点	聯繫點
氯霉素	氯黴素
控制室	控制室
说闲话	說閒話
强奸犯	強姦犯
闹别扭	鬧彆扭
天台山	天台山
合并症	合併症
旅游鞋	旅遊鞋
茅台酒	茅臺酒
正弦波	正弦波
控制键	控制鍵
片面性	片面性
样板戏	樣板戲
潜台词	潛臺詞
启发式	啟發式
履历表	履歷表
高才生	高才生
假面具	假面具
摄制组	攝製組
远征军	遠征軍
两面派	兩面派
上弦月	上弦月
首发式	首發式
感叹号	感歎號
预防针	預防針
黑糊糊	黑糊糊
小胡子	小鬍子
丢面子	丟面子
书面语	書面語
链霉素	鏈黴素
染发剂	染髮劑
闹哄哄	鬧哄哄
肩并肩	肩並肩
短纤维	短纖維
识别码	識別碼
场面上	場面上
蒸发量	蒸發量
牙周病	牙周病
拜占庭	拜占庭
街面上	街面上
篮板球	籃板球
开发性	開發性
球面镜	球面鏡
曲别针	曲別針
冷板凳	冷板凳
开后门	開後門
枪杆子	槍桿子
书卷气	書卷氣
厅局级	廳局級
拖后腿	拖後腿
交汇点	交匯點
皮划艇	皮划艇
消防栓	消防栓
控制论	控制論
地板砖	地板磚
夏蒙尼	夏蒙尼
莫干山	莫干山
笑面虎	笑面虎
近几天	近幾天
多面体	多面體
三板斧	三板斧
留后路	留後路
白云观	白雲觀
老糊涂	老糊塗
农历年	農曆年
水准仪	水準儀
摩托艇	摩托艇
蒲松龄	蒲松齡
肌纤维	肌纖維
批准书	批准書
大后方	大後方
醋坛子	醋罈子
窝里斗	窩裏鬥
阿托品	阿托品
甜面酱	甜麵醬
耳旁风	耳旁風
土霉素	土黴素
地面水	地面水
明后天	明後天
惊叹号	驚歎號
打游击	打游擊
五里河	五里河
立面图	立面圖
叮当响	叮噹響
圆周率	圓周率
词汇学	詞彙學
留余地	留餘地
织布机	織布機
雾蒙蒙	霧濛濛
雨蒙蒙	雨濛濛
下弦月	下弦月
凿岩机	鑿岩機
场面话	場面話
开采权	開採權
半吊子	半吊子
关系户	關係戶
笔杆子	筆桿子
金霉素	金黴素
大后天	大後天
擀面杖	擀麵杖
吐谷浑	吐谷渾
战斗队	戰鬥隊
转发器	轉發器
前后脚	前後腳
挥发油	揮發油
棉纤维	棉纖維
小个子	小個子
怒冲冲	怒沖沖
正当中	正當中
牙周炎	牙周炎
请愿书	請願書
三只手	三隻手
平面镜	平面鏡
黑面包	黑麵包
平板车	平板車
闹饥荒	鬧饑荒
地面站	地面站
祖冲之	祖沖之
译制片	譯製片
美术字	美術字
剖面图	剖面圖
圆面积	圓面積
特别法	特別法
吉卜赛	吉卜賽
三棱镜	三稜鏡
来复枪	來復槍
换向器	換向器
哈里发	哈里發
吃闲饭	吃閒飯
标准粉	標準粉
地板革	地板革
多党制	多黨制
浮夸风	浮誇風
麻纤维	麻纖維
四面体	四面體
白蒙蒙	白濛濛
包干制	包乾制
五里雾	五里霧
七弦琴	七弦琴
梦游症	夢遊症
串并联	串並聯
撑杆跳	撐杆跳
催干剂	催乾劑
多棱镜	多稜鏡
站台票	站臺票
墨斗鱼	墨斗魚
美术界	美術界
感叹句	感歎句
创汇额	創匯額
腰杆子	腰桿子
仙后座	仙后座
标准音	標準音
六弦琴	六弦琴
美术片	美術片
基准面	基準面
正当年	正當年
屋里人	屋裏人
打摆子	打擺子
触霉头	觸霉頭
章回体	章回體
交杯酒	交杯酒
方向舵	方向舵
刮胡刀	刮鬍刀
凸面镜	凸面鏡
对台戏	對臺戲
夹板气	夾板氣
理发馆	理髮館
呼吁书	呼籲書
黑蒙蒙	黑濛濛
判别式	判別式
打板子	打板子
扯后腿	扯後腿
标准语	標準語
文征明	文徵明
买面子	買面子
试制品	試製品
两党制	兩黨制
内当家	內當家
眼面前	眼面前
铺面房	鋪面房
大后年	大後年
打冲锋	打衝鋒
拉后腿	拉後腿
圆周角	圓周角
顺杆爬	順桿爬
渔获量	漁獲量
平面角	平面角
半制品	半製品
捕获量	捕獲量
气吁吁	氣吁吁
凹面镜	凹面鏡
门面话	門面話
月台票	月臺票
场面人	場面人
帆布床	帆布牀
打饥荒	打饑荒
换发球	換發球
窝里横	窩裏橫
压台戏	壓臺戲
喜冲冲	喜沖沖
碍面子	礙面子
胎里素	胎裏素
驳面子	駁面子
爆发音	爆發音
留后手	留後手
八斗才	八斗才
在这里	在這裏
留言板	留言板
第一个	第一個
另一个	另一個
每一个	每一個
下一个	下一個
上一个	上一個
电视台	電視臺
一方面	一方面
世界杯	世界盃
管理局	管理局
共产党	共產黨
适用于	適用於
有利于	有利於
这方面	這方面
第二个	第二個
来源于	來源於
新技术	新技術
公安局	公安局
有助于	有助於
黄金周	黃金週
各方面	各方面
三国志	三國志
教育局	教育局
一分钟	一分鐘
取决于	取決於
来自于	來自於
港澳台	港澳臺
不同于	不同於
剪贴板	剪貼板
没关系	沒關係
应用于	應用於
股份制	股份制
不属于	不屬於
工商局	工商局
相对于	相對於
以至于	以至於
民主党	民主黨
多方面	多方面
第三个	第三個
十分钟	十分鐘
不利于	不利於
统计局	統計局
时间表	時間表
适合于	適合於
正处于	正處於
不至于	不至於
国民党	國民黨
收银台	收銀臺
两方面	兩方面
不等于	不等於
脑子里	腦子裏
有计划	有計劃
不低于	不低於
工程系	工程系
气象局	氣象局
有关系	有關係
天花板	天花板
一览表	一覽表
时刻表	時刻表
责任制	責任制
仅次于	僅次於
所有制	所有制
环保局	環保局
莫过于	莫過於
林业局	林業局
好一个	好一個
公有制	公有制
卫生局	衛生局
无限制	無限制
高技术	高技術
申请表	申請表
财政局	財政局
农业局	農業局
物价局	物價局
人事局	人事局
着眼于	著眼於
骨子里	骨子裏
税务局	稅務局
文化局	文化局
服务台	服務臺
始建于	始建於
冠军杯	冠軍盃
博士后	博士後
马德里	馬德里
荷尔蒙	荷爾蒙
二进制	二進制
热衷于	熱衷於
方便面	方便麵
习惯于	習慣於
政治局	政治局
天文台	天文臺
作用于	作用於
综合征	綜合徵
日程表	日程表
覆盖面	覆蓋面
不情愿	不情願
血小板	血小板
综合症	綜合症
立足于	立足於
满足于	滿足於
性关系	性關係
邮政局	郵政局
警察局	警察局
登记表	登記表
等同于	等同於
高标准	高標準
略高于	略高於
全日制	全日制
不亚于	不亞於
太阳系	太陽系
中文系	中文系
徐家汇	徐家匯
监察局	監察局
电路板	電路板
甚至于	甚至於
有区别	有區別
不相干	不相干
而在于	而在於
一日游	一日遊
粮食局	糧食局
民政局	民政局
单方面	單方面
马拉松	馬拉松
尿毒症	尿毒症
共和党	共和黨
工作台	工作臺
隶属于	隸屬於
气象台	氣象臺
司法局	司法局
按计划	按計劃
有益于	有益於
无异于	無異於
女同志	女同志
水利局	水利局
电信局	電信局
相一致	相一致
德意志	德意志
归功于	歸功於
房管局	房管局
对照表	對照表
电熨斗	電熨斗
亚洲杯	亞洲盃
新动向	新動向
档案局	檔案局
实名制	實名制
执政党	執政黨
借助于	藉助於
原计划	原計劃
玻璃杯	玻璃杯
调查表	調查表
审计局	審計局
知识面	知識面
银河系	銀河系
侧重于	側重於
拿不准	拿不準
统计表	統計表
花岗岩	花崗岩
负责制	負責制
中下游	中下游
以利于	以利於
斜对面	斜對面
大半个	大半個
报名表	報名表
运用于	運用於
明细表	明細表
大方向	大方向
劳动局	勞動局
数学系	數學系
欧洲杯	歐洲盃
新德里	新德里
卡路里	卡路里
钓鱼台	釣魚臺
招商局	招商局
满洲里	滿洲里
适应症	適應症
有待于	有待於
对立面	對立面
多动症	多動症
解放后	解放後
反对党	反對黨
线路板	線路板
归咎于	歸咎於
有感于	有感於
情报局	情報局
价目表	價目表
求助于	求助於
人造板	人造板
有赖于	有賴於
外语系	外語系
中央台	中央臺
课程表	課程表
会员制	會員制
偏重于	偏重於
男同志	男同志
动手术	動手術
不敢当	不敢當
建国后	建國後
核技术	核技術
电线杆	電線杆
地方志	地方誌
投身于	投身於
百老汇	百老匯
社会党	社會黨
铁路局	鐵路局
主席台	主席臺
不孕症	不孕症
败血症	敗血症
千百万	千百萬
化学系	化學系
西西里	西西里
安全局	安全局
供电局	供電局
冷不防	冷不防
集中制	集中制
工业局	工業局
梳妆台	梳妝臺
广播台	廣播臺
测绘局	測繪局
多见于	多見於
不屑于	不屑於
胶合板	膠合板
无愧于	無愧於
宇航局	宇航局
信天游	信天游
压力表	壓力錶
航天局	航天局
玉米面	玉米麵
涨停板	漲停板
阴暗面	陰暗面
索马里	索馬里
海平面	海平面
领奖台	領獎臺
肥胖症	肥胖症
写字台	寫字檯
交白卷	交白卷
背地里	背地裏
矿务局	礦務局
晴雨表	晴雨錶
皇太后	皇太后
祝英台	祝英臺
哥伦布	哥倫布
沉醉于	沉醉於
哲学系	哲學系
出自于	出自於
坐标系	坐標系
生物系	生物系
黑手党	黑手黨
核计划	核計劃
邮电局	郵電局
生物钟	生物鐘
尼克松	尼克松
豆腐干	豆腐乾
私有制	私有制
四下里	四下裏
红萝卜	紅蘿蔔
终身制	終身制
催眠术	催眠術
跷跷板	蹺蹺板
强加于	強加於
电业局	電業局
石灰岩	石灰岩
自闭症	自閉症
归因于	歸因於
乃至于	乃至於
调色板	調色板
宣传周	宣傳週
烽火台	烽火臺
在野党	在野黨
工作面	工作面
滑雪板	滑雪板
电子表	電子錶
合同制	合同制
写字板	寫字板
专利局	專利局
遮羞布	遮羞布
莱索托	萊索托
葡萄干	葡萄乾
操作台	操作臺
暗地里	暗地裏
十进制	十進制
学分制	學分制
保守党	保守黨
断头台	斷頭臺
塑料布	塑料布
新闻系	新聞系
双轨制	雙軌制
上上签	上上籤
聘任制	聘任制
革命党	革命黨
正反面	正反面
有损于	有損於
脚踏板	腳踏板
有悖于	有悖於
脑震荡	腦震盪
巴尔干	巴爾幹
八进制	八進制
五棵松	五棵松
见世面	見世面
蘑菇云	蘑菇雲
不下于	不下於
拉关系	拉關係
跌停板	跌停板
奴隶制	奴隸制
对着干	對著幹
保温杯	保溫杯
水平面	水平面
港务局	港務局
电压表	電壓錶
君主制	君主制
贴标签	貼標籤
城建局	城建局
火山岩	火山岩
字母表	字母表
说不准	說不準
电度表	電度錶
炸酱面	炸醬麵
等级制	等級制
赛程表	賽程表
承包制	承包制
地下党	地下黨
聘用制	聘用制
七巧板	七巧板
百分制	百分制
一贯制	一貫制
分税制	分稅制
共和制	共和制
电流表	電流錶
印刷术	印刷術
水泥板	水泥板
刀削面	刀削麵
参照系	參照系
头一回	頭一回
平衡表	平衡表
横断面	橫斷面
石英钟	石英鐘
普惠制	普惠制
百分表	百分表
落叶松	落葉松
决胜局	決勝局
担担面	擔擔麵
黄曲霉	黃麴黴
吃不准	吃不準
踢脚板	踢腳板
三角板	三角板
打擂台	打擂臺
老白干	老白乾
火烧云	火燒雲
单位制	單位制
体温表	體溫錶
横切面	橫切面
马尾松	馬尾松
家长制	家長制
观象台	觀象臺
农奴制	農奴制
老皇历	老皇曆
三和弦	三和弦
脚底板	腳底板
水电局	水電局
物资局	物資局
查号台	查號臺
撑门面	撐門面
撑场面	撐場面
裹脚布	裹腳布
沉积岩	沉積岩
龙须面	龍鬚麵
阳春面	陽春麵
装门面	裝門面
阴阳历	陰陽曆
议会制	議會制
打照面	打照面
井田制	井田制
勘误表	勘誤表
抛物面	拋物面
铺盖卷	鋪蓋捲
太阳历	太陽曆
自鸣钟	自鳴鐘
纵断面	縱斷面
夏时制	夏時制
棒子面	棒子麵
猛不防	猛不防
注意事项	注意事項
复旦大学	復旦大學
后顾之忧	後顧之憂
游山玩水	遊山玩水
尽管如此	儘管如此
胡思乱想	胡思亂想
当务之急	當務之急
胡说八道	胡說八道
志同道合	志同道合
当地时间	當地時間
别出心裁	別出心裁
于公于私	於公於私
别有用心	別有用心
别具一格	別具一格
胡言乱语	胡言亂語
面面相觑	面面相覷
防不胜防	防不勝防
干干净净	乾乾淨淨
万事如意	萬事如意
复合材料	複合材料
当之无愧	當之無愧
叹为观止	歎爲觀止
别无选择	別無選擇
回心转意	回心轉意
荡气回肠	蕩氣迴腸
面目全非	面目全非
面红耳赤	面紅耳赤
卷土重来	捲土重來
发扬光大	發揚光大
蒙特利尔	蒙特利爾
万无一失	萬無一失
游刃有余	遊刃有餘
准确无误	準確無誤
当机立断	當機立斷
扎扎实实	紮紮實實
回味无穷	回味無窮
万水千山	萬水千山
尽善尽美	盡善盡美
尽收眼底	盡收眼底
尽心尽力	盡心盡力
布鲁塞尔	布魯塞爾
历历在目	歷歷在目
才华横溢	才華橫溢
赞不绝口	讚不絕口
周而复始	周而復始
荡然无存	蕩然無存
糊里糊涂	糊裏糊塗
并驾齐驱	並駕齊驅
面面俱到	面面俱到
胡萝卜素	胡蘿蔔素
哗众取宠	譁眾取寵
闲情逸致	閒情逸致
发号施令	發號施令
游手好闲	游手好閒
尽职尽责	盡職盡責
万里长城	萬里長城
冲锋陷阵	衝鋒陷陣
郁郁葱葱	鬱鬱蔥蔥
旁若无人	旁若無人
别开生面	別開生面
并肩作战	並肩作戰
别有洞天	別有洞天
个人主义	個人主義
蒙娜丽莎	蒙娜麗莎
后来居上	後來居上
后悔莫及	後悔莫及
据为己有	據爲己有
尽力而为	盡力而爲
面不改色	面不改色
闲言碎语	閒言碎語
当仁不让	當仁不讓
布达拉宫	布達拉宮
哄堂大笑	哄堂大笑
干净利落	乾淨利落
汇丰银行	滙豐銀行
回眸一笑	回眸一笑
发人深省	發人深省
舍我其谁	捨我其誰
后起之秀	後起之秀
只言片语	隻言片語
云淡风轻	雲淡風輕
万不得已	萬不得已
志在必得	志在必得
于事无补	於事無補
回过头来	回過頭來
万劫不复	萬劫不復
万有引力	萬有引力
托尔斯泰	托爾斯泰
蒙在鼓里	蒙在鼓裏
万般无奈	萬般無奈
闲云野鹤	閒雲野鶴
尽如人意	盡如人意
万家灯火	萬家燈火
里里外外	裏裏外外
回头是岸	回頭是岸
杯水车薪	杯水車薪
据理力争	據理力爭
当家作主	當家作主
万事大吉	萬事大吉
胡作非为	胡作非爲
郁郁寡欢	鬱鬱寡歡
个体经济	個體經濟
才子佳人	才子佳人
别有风味	別有風味
旁观者清	旁觀者清
赞叹不已	讚歎不已
夸大其词	誇大其詞
只争朝夕	只爭朝夕
表面文章	表面文章
朴实无华	樸實無華
几何图形	幾何圖形
蒙混过关	蒙混過關
防毒面具	防毒面具
万紫千红	萬紫千紅
饥寒交迫	飢寒交迫
旁门左道	旁門左道
万念俱灰	萬念俱灰
里应外合	裏應外合
表里如一	表裏如一
才高八斗	才高八斗
万众一心	萬眾一心
冲昏头脑	沖昏頭腦
夸夸其谈	誇誇其談
斗转星移	斗轉星移
只字不提	隻字不提
万里无云	萬里無雲
于心不忍	於心不忍
饥肠辘辘	飢腸轆轆
后患无穷	後患無窮
发人深思	發人深思
余音绕梁	餘音繞梁
吊儿郎当	吊兒郎當
万事俱备	萬事俱備
发家致富	發家致富
胡志明市	胡志明市
舍近求远	捨近求遠
旁敲侧击	旁敲側擊
后生可畏	後生可畏
后会有期	後會有期
干劲十足	幹勁十足
布达佩斯	布達佩斯
弦外之音	弦外之音
当头一棒	當頭一棒
回光返照	迴光返照
别来无恙	別來無恙
历久弥新	歷久彌新
干脆利落	乾脆利落
饥不择食	飢不擇食
面有难色	面有難色
钟灵毓秀	鍾靈毓秀
局促不安	侷促不安
表里不一	表裏不一
面目可憎	面目可憎
党纪国法	黨紀國法
尽人皆知	盡人皆知
尸横遍野	屍橫遍野
当头棒喝	當頭棒喝
万马奔腾	萬馬奔騰
舍生取义	捨生取義
后继有人	後繼有人
干柴烈火	乾柴烈火
只欠东风	只欠東風
防暑降温	防暑降溫
后发制人	後發制人
当局者迷	當局者迷
胡搅蛮缠	胡攪蠻纏
防微杜渐	防微杜漸
才疏学浅	才疏學淺
才貌双全	才貌雙全
万里长征	萬里長征
纤尘不染	纖塵不染
发奋图强	發奮圖強
万人空巷	萬人空巷
斗志昂扬	鬥志昂揚
松赞干布	松贊干布
舍生忘死	捨生忘死
防患未然	防患未然
刨根问底	刨根問底
愿者上钩	願者上鉤
松松垮垮	鬆鬆垮垮
面无人色	面無人色
万夫莫开	萬夫莫開
别具匠心	別具匠心
面如土色	面如土色
万寿无疆	萬壽無疆
志在千里	志在千里
面黄肌瘦	面黃肌瘦
万籁俱寂	萬籟俱寂
志在四方	志在四方
旁征博引	旁徵博引
尽心竭力	盡心竭力
划清界限	劃清界限
几次三番	幾次三番
舍己为人	捨己爲人
并行不悖	並行不悖
板上钉钉	板上釘釘
万象更新	萬象更新
舍本逐末	捨本逐末
志士仁人	志士仁人
杯弓蛇影	杯弓蛇影
丑态百出	醜態百出
后院起火	後院起火
云蒸霞蔚	雲蒸霞蔚
后事之师	後事之師
于心何忍	於心何忍
哄抬物价	哄擡物價
云山雾罩	雲山霧罩
舍己救人	捨己救人
万贯家财	萬貫家財
面貌一新	面貌一新
胡子拉碴	鬍子拉碴
回肠荡气	迴腸蕩氣
闲杂人员	閒雜人員
万马齐喑	萬馬齊瘖
别无二致	別無二致
后人乘凉	後人乘涼
后继乏人	後繼乏人
发愤图强	發憤圖強
里急后重	裏急後重
回天乏术	回天乏術
党同伐异	黨同伐異
万死不辞	萬死不辭
坛坛罐罐	罈罈罐罐
郁郁不乐	鬱鬱不樂
回天之力	回天之力
万古流芳	萬古流芳
摆龙门阵	擺龍門陣
杯盘狼藉	杯盤狼藉
别有天地	別有天地
面目一新	面目一新
志大才疏	志大才疏
尸位素餐	尸位素餐
防卫过当	防衛過當
布尔乔亚	布爾喬亞
面授机宜	面授機宜
于情于理	於情於理
糊涂一时	糊塗一時
表意文字	表意文字
万全之策	萬全之策
钟鸣鼎食	鐘鳴鼎食
夸父逐日	夸父逐日
尽忠报国	盡忠報國
万籁无声	萬籟無聲
万古长青	萬古長青
蒙蒙细雨	濛濛細雨
余波未平	餘波未平
奸淫掳掠	姦淫擄掠
后继无人	後繼無人
志得意满	志得意滿
当断不断	當斷不斷
别树一帜	別樹一幟
万头攒动	萬頭攢動
谷贱伤农	穀賤傷農
云消雾散	雲消霧散
万儿八千	萬兒八千
夸下海口	誇下海口
别无长物	別無長物
松松散散	鬆鬆散散
旁系亲属	旁系親屬
愿闻其详	願聞其詳
舍死忘生	捨死忘生
干劲冲天	幹勁沖天
万事亨通	萬事亨通
纤维植物	纖維植物
面有菜色	面有菜色
斗鸡走狗	鬥雞走狗
蒙昧主义	蒙昧主義
云开见日	雲開見日
向隅而泣	向隅而泣
尸骨未寒	屍骨未寒
才德兼备	才德兼備
吊民伐罪	弔民伐罪
万缕千丝	萬縷千絲
万古千秋	萬古千秋
蒙昧无知	蒙昧無知
里通外国	裏通外國
云泥之别	雲泥之別
万夫不当	萬夫不當
万箭攒心	萬箭攢心
鉴往知来	鑑往知來
表里一致	表裏一致
别无出路	別無出路
尽其所有	盡其所有
余勇可贾	餘勇可賈
云谲波诡	雲譎波詭
向壁虚构	向壁虛構
饥餐渴饮	飢餐渴飲
别具只眼	別具隻眼
发短心长	髮短心長
回嗔作喜	回嗔作喜
蒙头转向	矇頭轉向
茶余饭后	茶餘飯後
计划生育	計劃生育
近几年来	近幾年來
百万富翁	百萬富翁
淋漓尽致	淋漓盡致
四面八方	四面八方
上当受骗	上當受騙
上个世纪	上個世紀
十面埋伏	十面埋伏
对症下药	對症下藥
字里行间	字裏行間
业余时间	業餘時間
兴致勃勃	興致勃勃
亚历山大	亞歷山大
行云流水	行雲流水
旅游胜地	旅遊勝地
不复存在	不復存在
斯里兰卡	斯里蘭卡
外汇储备	外匯儲備
日复一日	日復一日
业余爱好	業餘愛好
模糊不清	模糊不清
艺术作品	藝術作品
竭尽全力	竭盡全力
如愿以偿	如願以償
人云亦云	人云亦云
首当其冲	首當其衝
绞尽脑汁	絞盡腦汁
峰回路转	峰迴路轉
大发雷霆	大發雷霆
风云变幻	風雲變幻
稀里糊涂	稀裏糊塗
千里迢迢	千里迢迢
曾几何时	曾幾何時
先发制人	先發制人
风云人物	風雲人物
雨后春笋	雨後春筍
年复一年	年復一年
行尸走肉	行屍走肉
所向披靡	所向披靡
四面楚歌	四面楚歌
疲于奔命	疲於奔命
多才多艺	多才多藝
死里逃生	死裏逃生
忙里偷闲	忙裏偷閒
众志成城	眾志成城
毛里求斯	毛里求斯
大获全胜	大獲全勝
十万火急	十萬火急
德才兼备	德才兼備
另当别论	另當別論
神采飞扬	神采飛揚
另辟蹊径	另闢蹊徑
粗制滥造	粗製濫造
以防万一	以防萬一
读万卷书	讀萬卷書
神采奕奕	神采奕奕
竭尽所能	竭盡所能
忠于职守	忠於職守
横冲直撞	橫衝直撞
急于求成	急於求成
力挽狂澜	力挽狂瀾
雾里看花	霧裏看花
怒发冲冠	怒髮衝冠
溢于言表	溢於言表
怀才不遇	懷才不遇
前后左右	前後左右
孤注一掷	孤注一擲
口干舌燥	口乾舌燥
光纤通信	光纖通信
最后通牒	最後通牒
开卷有益	開卷有益
模棱两可	模稜兩可
所向无敌	所向無敵
证据确凿	證據確鑿
郎才女貌	郎才女貌
壮志凌云	壯志凌雲
摇摆不定	搖擺不定
五脏六腑	五臟六腑
风云突变	風雲突變
双向选择	雙向選擇
各个击破	各個擊破
人尽其才	人盡其才
白发苍苍	白髮蒼蒼
人才济济	人才濟濟
噼里啪啦	劈裏啪啦
亭台楼阁	亭臺樓閣
费尽心机	費盡心機
门当户对	門當戶對
老当益壮	老當益壯
毁于一旦	毀於一旦
直系亲属	直系親屬
有鉴于此	有鑑於此
奋发向上	奮發向上
高于一切	高於一切
难舍难分	難捨難分
动荡不安	動盪不安
如饥似渴	如飢似渴
安于现状	安於現狀
劫后余生	劫後餘生
死于非命	死於非命
反复无常	反覆無常
真才实学	真才實學
奋发图强	奮發圖強
独占鳌头	獨佔鼇頭
重于泰山	重於泰山
赶尽杀绝	趕盡殺絕
一哄而上	一哄而上
闯荡江湖	闖蕩江湖
人才辈出	人才輩出
翻云覆雨	翻雲覆雨
挥洒自如	揮灑自如
北回归线	北回歸線
债台高筑	債臺高築
一面之缘	一面之緣
稳扎稳打	穩紮穩打
奋发有为	奮發有爲
叽里呱啦	嘰裏呱啦
人面桃花	人面桃花
物尽其用	物盡其用
花里胡哨	花裏胡哨
阴云密布	陰雲密佈
八面玲珑	八面玲瓏
苦尽甘来	苦盡甘來
腾云驾雾	騰雲駕霧
受制于人	受制於人
独辟蹊径	獨闢蹊徑
百发百中	百發百中
严于律己	嚴於律己
剩余价值	剩餘價值
南征北战	南征北戰
有板有眼	有板有眼
放荡不羁	放蕩不羈
四舍五入	四捨五入
丧尽天良	喪盡天良
正当防卫	正當防衛
长吁短叹	長吁短嘆
稀里哗啦	稀裏嘩啦
千里之行	千里之行
博采众长	博採眾長
未卜先知	未卜先知
久别重逢	久別重逢
反面教材	反面教材
满面春风	滿面春風
雄才大略	雄才大略
风卷残云	風捲殘雲
马里亚纳	馬里亞納
老奸巨猾	老奸巨猾
始于足下	始於足下
一板一眼	一板一眼
一表人才	一表人才
由表及里	由表及裏
一干二净	一乾二淨
铁板一块	鐵板一塊
风云际会	風雲際會
坑蒙拐骗	坑矇拐騙
居里夫人	居里夫人
反面人物	反面人物
笑里藏刀	笑裏藏刀
铁面无私	鐵面無私
矢志不渝	矢志不渝
一哄而散	一哄而散
下里巴人	下里巴人
心向往之	心嚮往之
等闲之辈	等閒之輩
浮游生物	浮游生物
青云直上	青雲直上
一面之词	一面之詞
含糊其辞	含糊其辭
春回大地	春回大地
不舍昼夜	不捨晝夜
各尽所能	各盡所能
弹尽粮绝	彈盡糧絕
章回小说	章回小說
预制构件	預製構件
叽里咕噜	嘰裏咕嚕
等闲视之	等閒視之
吞云吐雾	吞雲吐霧
改弦更张	改弦更張
止于至善	止於至善
垂帘听政	垂簾聽政
壮志未酬	壯志未酬
独当一面	獨當一面
管弦乐队	管弦樂隊
拨云见日	撥雲見日
五脏俱全	五臟俱全
愁云惨雾	愁雲慘霧
五谷丰登	五穀豐登
百里挑一	百裏挑一
两面三刀	兩面三刀
苍松翠柏	蒼松翠柏
阿布扎比	阿布扎比
话里有话	話裏有話
迂回曲折	迂迴曲折
心术不正	心術不正
有棱有角	有稜有角
自叹弗如	自嘆弗如
怪里怪气	怪裏怪氣
借尸还魂	借屍還魂
鹤发童颜	鶴髮童顏
光杆司令	光桿司令
斩尽杀绝	斬盡殺絕
改弦易辙	改弦易轍
恃才傲物	恃才傲物
千回百转	千迴百轉
秋后算账	秋後算賬
忍饥挨饿	忍飢挨餓
晨钟暮鼓	晨鐘暮鼓
头面人物	頭面人物
一面之交	一面之交
横征暴敛	橫征暴斂
慌里慌张	慌裏慌張
结党营私	結黨營私
如获至宝	如獲至寶
一哄而起	一哄而起
收回成命	收回成命
作奸犯科	作奸犯科
鞭辟入里	鞭辟入裏
千里之堤	千里之堤
四个坚持	四個堅持
平面几何	平面幾何
黄钟大吕	黃鐘大呂
白面书生	白面書生
土里土气	土裏土氣
自摆乌龙	自擺烏龍
八面威风	八面威風
南回归线	南回歸線
永志不忘	永誌不忘
溃于蚁穴	潰於蟻穴
铁板钉钉	鐵板釘釘
白云苍狗	白雲蒼狗
绵里藏针	綿裏藏針
草台班子	草臺班子
老于世故	老於世故
沙里淘金	沙裏淘金
官复原职	官復原職
鸟尽弓藏	鳥盡弓藏
五谷不分	五穀不分
不干不净	不乾不淨
轻于鸿毛	輕於鴻毛
子丑寅卯	子丑寅卯
出于无奈	出於無奈
慨当以慷	慨當以慷
克尽职守	克盡職守
强奸民意	強姦民意
空谷足音	空谷足音
能征善战	能征善戰
剩余劳动	剩餘勞動
鸠占鹊巢	鳩佔鵲巢
吃后悔药	吃後悔藥
席卷天下	席捲天下
席卷一空	席捲一空
曲里拐弯	曲裏拐彎
吉卜赛人	吉卜賽人
青面獠牙	青面獠牙
大发慈悲	大發慈悲
仰面朝天	仰面朝天
人面兽心	人面獸心
结发夫妻	結髮夫妻
抑郁寡欢	抑鬱寡歡
兴致索然	興致索然
傻里傻气	傻里傻氣
殷鉴不远	殷鑑不遠
费尽心血	費盡心血
无尽无休	無盡無休
穿云裂石	穿雲裂石
流里流气	流裏流氣
朝发夕至	朝發夕至
拍板成交	拍板成交
包干到户	包乾到戶
妖里妖气	妖裏妖氣
皮里阳秋	皮裏陽秋
形只影单	形隻影單
连台本戏	連臺本戲
吃里爬外	吃裏爬外
啼饥号寒	啼飢號寒
能征惯战	能征慣戰
穿云破雾	穿雲破霧
烘云托月	烘雲托月
喷云吐雾	噴雲吐霧
气冲牛斗	氣沖牛斗
量才录用	量才錄用
心脏死亡	心臟死亡
薪尽火传	薪盡火傳
曲尽其妙	曲盡其妙
来回来去	來回來去
气冲霄汉	氣沖霄漢
囿于成见	囿於成見
密云不雨	密雲不雨
弹尽援绝	彈盡援絕
露才扬己	露才揚己
唾面自干	唾面自乾
凌云之志	凌雲之志
一发千钧	一髮千鈞
千回百折	千迴百折
偷奸取巧	偷奸取巧
不赞一词	不讚一詞
嘀里嘟噜	嘀裏嘟嚕
舌面前音	舌面前音
繁征博引	繁徵博引
操作系统	操作系統
建筑面积	建築面積
应有尽有	應有盡有
充分发挥	充分發揮
规章制度	規章制度
理所当然	理所當然
众所周知	眾所周知
一塌糊涂	一塌糊塗
引人注目	引人注目
雷霆万钧	雷霆萬鈞
神经系统	神經系統
一见钟情	一見鍾情
严重后果	嚴重後果
方方面面	方方面面
迷迷糊糊	迷迷糊糊
生长发育	生長發育
蓬勃发展	蓬勃發展
因地制宜	因地制宜
图文并茂	圖文並茂
无动于衷	無動於衷
香格里拉	香格里拉
起死回生	起死回生
提心吊胆	提心吊膽
不遗余力	不遺餘力
相提并论	相提並論
兴高采烈	興高采烈
烟消云散	煙消雲散
命中注定	命中注定
风起云涌	風起雲湧
合成纤维	合成纖維
气喘吁吁	氣喘吁吁
千家万户	千家萬戶
出谋划策	出謀劃策
千千万万	千千萬萬
欣欣向荣	欣欣向榮
错综复杂	錯綜複雜
聪明才智	聰明才智
生态系统	生態系統
千变万化	千變萬化
无济于事	無濟於事
浩浩荡荡	浩浩蕩蕩
本来面目	本來面目
文艺复兴	文藝復興
分门别类	分門別類
千辛万苦	千辛萬苦
佛罗里达	佛羅里達
死灰复燃	死灰復燃
乌兹别克	烏茲別克
恭喜发财	恭喜發財
同归于尽	同歸於盡
反反复复	反反覆覆
不绝于耳	不絕於耳
耿耿于怀	耿耿於懷
事与愿违	事與願違
供大于求	供大於求
共产党人	共產黨人
民主党派	民主黨派
津巴布韦	津巴布韋
心有余悸	心有餘悸
千言万语	千言萬語
前前后后	前前後後
包罗万象	包羅萬象
世界历史	世界歷史
资金周转	資金周轉
不堪回首	不堪回首
瞬息万变	瞬息萬變
循环系统	循環系統
感慨万千	感慨萬千
倾家荡产	傾家蕩產
千山万水	千山萬水
青出于蓝	青出於藍
千丝万缕	千絲萬縷
大肠杆菌	大腸桿菌
供过于求	供過於求
阶级斗争	階級鬥爭
千军万马	千軍萬馬
怒气冲冲	怒氣沖沖
寓教于乐	寓教於樂
耕地面积	耕地面積
闻名于世	聞名於世
数以万计	數以萬計
学以致用	學以致用
播种面积	播種面積
兴旺发达	興旺發達
袖手旁观	袖手旁觀
千真万确	千真萬確
精神面貌	精神面貌
公安局长	公安局長
令人发指	令人髮指
千呼万唤	千呼萬喚
脱贫致富	脫貧致富
勾心斗角	勾心鬥角
模模糊糊	模模糊糊
引经据典	引經據典
财务制度	財務制度
前仆后继	前仆後繼
千差万别	千差萬別
过眼云烟	過眼雲煙
专心致志	專心致志
责无旁贷	責無旁貸
霸王别姬	霸王別姬
多管闲事	多管閒事
鞠躬尽瘁	鞠躬盡瘁
前功尽弃	前功盡棄
冷眼旁观	冷眼旁觀
幸免于难	幸免於難
聊斋志异	聊齋誌異
失而复得	失而復得
一马当先	一馬當先
难得糊涂	難得糊塗
青红皂白	青紅皁白
一飞冲天	一飛沖天
利比里亚	利比里亞
晴空万里	晴空萬里
开天辟地	開天闢地
箭在弦上	箭在弦上
前因后果	前因後果
水力发电	水力發電
子孙后代	子孫後代
出奇制胜	出奇制勝
指挥系统	指揮系統
齐头并进	齊頭並進
轻轻松松	輕輕鬆鬆
九霄云外	九霄雲外
前赴后继	前赴後繼
火力发电	火力發電
预备党员	預備黨員
不减当年	不減當年
争奇斗艳	爭奇鬥豔
移情别恋	移情別戀
一本万利	一本萬利
无以复加	無以復加
洋洋洒洒	洋洋灑灑
供电系统	供電系統
宁静致远	寧靜致遠
腰缠万贯	腰纏萬貫
千头万绪	千頭萬緒
止跌回升	止跌回升
天天向上	天天向上
植物纤维	植物纖維
开诚布公	開誠佈公
公之于众	公之於眾
浮动汇率	浮動匯率
妙手回春	妙手回春
公安干警	公安幹警
气象万千	氣象萬千
唉声叹气	唉聲嘆氣
勿施于人	勿施於人
满满当当	滿滿當當
巴尔扎克	巴爾扎克
千刀万剐	千刀萬剮
喜形于色	喜形於色
利大于弊	利大於弊
声情并茂	聲情並茂
江郎才尽	江郎才盡
和盘托出	和盤托出
遗臭万年	遺臭萬年
最近几年	最近幾年
经济制裁	經濟制裁
生物防治	生物防治
大动干戈	大動干戈
对酒当歌	對酒當歌
响彻云霄	響徹雲霄
浪子回头	浪子回頭
借题发挥	借題發揮
留有余地	留有餘地
触类旁通	觸類旁通
含含糊糊	含含糊糊
封建制度	封建制度
家长里短	家長里短
数罪并罚	數罪併罰
前呼后拥	前呼後擁
日理万机	日理萬機
亲子鉴定	親子鑑定
圣莫里茨	聖莫里茨
武装斗争	武裝鬥爭
风流才子	風流才子
安营扎寨	安營紮寨
升官发财	升官發財
争奇斗妍	爭奇鬥妍
惊恐万状	驚恐萬狀
仁人志士	仁人志士
死而后已	死而後已
排除万难	排除萬難
前仰后合	前仰後合
死有余辜	死有餘辜
死而复生	死而復生
人造纤维	人造纖維
摇头摆尾	搖頭擺尾
耳提面命	耳提面命
花样游泳	花樣游泳
不远万里	不遠萬里
人浮于事	人浮於事
散兵游勇	散兵游勇
振聋发聩	振聾發聵
马拉松赛	馬拉松賽
格物致知	格物致知
红得发紫	紅得發紫
取信于民	取信於民
稳稳当当	穩穩當當
思绪万千	思緒萬千
兼收并蓄	兼收並蓄
一夫当关	一夫當關
聊胜于无	聊勝於無
悔不当初	悔不當初
先斩后奏	先斬後奏
聚酯纤维	聚酯纖維
任人摆布	任人擺佈
克敌制胜	克敵制勝
光芒万丈	光芒萬丈
打预防针	打預防針
窗明几净	窗明几淨
艰苦朴素	艱苦樸素
携手并肩	攜手並肩
业精于勤	業精於勤
络腮胡子	絡腮鬍子
优哉游哉	優哉遊哉
打道回府	打道回府
兼容并包	兼容並包
大敌当前	大敵當前
人心向背	人心向背
墨索里尼	墨索里尼
千难万险	千難萬險
先来后到	先來後到
旧病复发	舊病復發
强加于人	強加於人
前俯后仰	前俯後仰
怒气冲天	怒氣沖天
鼓足干劲	鼓足幹勁
以一当十	以一當十
言归于好	言歸於好
仪态万方	儀態萬方
钩心斗角	鉤心鬥角
千秋万代	千秋萬代
唱对台戏	唱對臺戲
乌苏里江	烏蘇里江
先礼后兵	先禮後兵
大地回春	大地回春
坐冷板凳	坐冷板凳
行家里手	行家裏手
桌椅板凳	桌椅板凳
波谲云诡	波譎雲詭
凤凰于飞	鳳凰于飛
鹏程万里	鵬程萬里
行成于思	行成於思
克己复礼	克己復禮
因时制宜	因時制宜
千难万难	千難萬難
故态复萌	故態復萌
身残志坚	身殘志堅
长歌当哭	長歌當哭
螳臂当车	螳臂當車
耕作制度	耕作制度
先人后己	先人後己
感慨万端	感慨萬端
离题万里	離題萬里
千秋万岁	千秋萬歲
人穷志短	人窮志短
大权旁落	大權旁落
悠悠荡荡	悠悠蕩蕩
皇天后土	皇天后土
除旧布新	除舊佈新
嫁祸于人	嫁禍於人
风流云散	風流雲散
离情别绪	離情別緒
星移斗转	星移斗轉
千门万户	千門萬戶
千山万壑	千山萬壑
前倨后恭	前倨後恭
怒形于色	怒形於色
生存斗争	生存鬥爭
公之于世	公之於世
战天斗地	戰天鬥地
奋勇当先	奮勇當先
得而复失	得而復失
九曲回肠	九曲迴腸
车载斗量	車載斗量
叮零当啷	叮零噹啷
豺狼当道	豺狼當道
言不尽意	言不盡意
片言只语	片言隻語
罪该万死	罪該萬死
虎口余生	虎口餘生
矿物纤维	礦物纖維
安步当车	安步當車
光可鉴人	光可鑑人
黄曲霉菌	黃麴黴菌
左道旁门	左道旁門
前紧后松	前緊後鬆
千叮万嘱	千叮萬囑
孤身只影	孤身隻影
以观后效	以觀後效
怨气冲天	怨氣沖天
不分皂白	不分皁白
片纸只字	片紙隻字
前思后想	前思後想
先公后私	先公後私
罚不当罪	罰不當罪
改恶向善	改惡向善
因事制宜	因事制宜
深文周纳	深文周納
心慈面软	心慈面軟
连鬓胡子	連鬢鬍子
判若云泥	判若雲泥
步人后尘	步人後塵
不齿于人	不齒於人
残渣余孽	殘渣餘孽
片言只字	片言隻字
髀肉复生	髀肉復生
得胜回朝	得勝回朝
问道于盲	問道於盲
釜底游鱼	釜底游魚
齐足并驱	齊足並驅
独具只眼	獨具隻眼
另一方面	另一方面
一网打尽	一網打盡
广播电台	廣播電臺
成千上万	成千上萬
平方公里	平方公里
人际关系	人際關係
浮出水面	浮出水面
关键在于	關鍵在於
一触即发	一觸即發
心甘情愿	心甘情願
泪流满面	淚流滿面
不知所云	不知所云
优秀人才	優秀人才
艰苦奋斗	艱苦奮鬥
一言不发	一言不發
从此以后	從此以後
利害关系	利害關係
中日关系	中日關係
两国关系	兩國關係
报刊杂志	報刊雜誌
歇斯底里	歇斯底里
放在眼里	放在眼裏
情有独钟	情有獨鍾
努力奋斗	努力奮鬥
疑难杂症	疑難雜症
保持一致	保持一致
外科手术	外科手術
争先恐后	爭先恐後
无精打采	無精打采
晕头转向	暈頭轉向
一厢情愿	一廂情願
依依不舍	依依不捨
全神贯注	全神貫注
狼吞虎咽	狼吞虎嚥
大摇大摆	大搖大擺
无穷无尽	無窮無盡
天壤之别	天壤之別
一览无余	一覽無餘
不知去向	不知去向
意犹未尽	意猶未盡
因果关系	因果關係
近水楼台	近水樓臺
叱咤风云	叱吒風雲
蓄势待发	蓄勢待發
千钧一发	千鈞一髮
意气风发	意氣風發
寥寥无几	寥寥無幾
一无所获	一無所獲
空前绝后	空前絕後
直截了当	直截了當
猝不及防	猝不及防
有感而发	有感而發
左邻右舍	左鄰右舍
毛遂自荐	毛遂自薦
扣人心弦	扣人心弦
前车之鉴	前車之鑑
血肉模糊	血肉模糊
筋疲力尽	筋疲力盡
恋恋不舍	戀戀不捨
绰绰有余	綽綽有餘
所剩无几	所剩無幾
垂死挣扎	垂死掙扎
一前一后	一前一後
一国两制	一國兩制
埋头苦干	埋頭苦幹
雄心壮志	雄心壯志
错落有致	錯落有致
乌兰察布	烏蘭察布
锲而不舍	鍥而不捨
智力开发	智力開發
踌躇满志	躊躇滿志
厚积薄发	厚積薄發
单打独斗	單打獨鬥
一日千里	一日千里
真抓实干	真抓實幹
资治通鉴	資治通鑑
整装待发	整裝待發
抛头露面	拋頭露面
打击报复	打擊報復
生离死别	生離死別
网开一面	網開一面
容光焕发	容光煥發
取之不尽	取之不盡
火山爆发	火山爆發
毫不相干	毫不相干
不劳而获	不勞而獲
一言难尽	一言難盡
好戏连台	好戲連臺
为人师表	爲人師表
酣畅淋漓	酣暢淋漓
笑容满面	笑容滿面
以点带面	以點帶面
不辞而别	不辭而別
瞻前顾后	瞻前顧後
星罗棋布	星羅棋佈
同等学历	同等學歷
十六进制	十六進制
明争暗斗	明爭暗鬥
顾全大局	顧全大局
引进人才	引進人才
穷追不舍	窮追不捨
洗心革面	洗心革面
组织关系	組織關係
精疲力尽	精疲力盡
有理有据	有理有據
打家劫舍	打家劫舍
旗鼓相当	旗鼓相當
不学无术	不學無術
尊重人才	尊重人才
披头散发	披頭散髮
不治之症	不治之症
卡尔加里	卡爾加里
理所应当	理所應當
如法炮制	如法炮製
承前启后	承前啟後
改头换面	改頭換面
蓬头垢面	蓬頭垢面
思前想后	思前想後
龙争虎斗	龍爭虎鬥
虚怀若谷	虛懷若谷
一泻千里	一瀉千里
魂不守舍	魂不守舍
玩物丧志	玩物喪志
出人意表	出人意表
山穷水尽	山窮水盡
东窗事发	東窗事發
红光满面	紅光滿面
百年之后	百年之後
以泪洗面	以淚洗面
循环往复	循環往復
思想体系	思想體系
紧追不舍	緊追不捨
甘心情愿	甘心情願
平步青云	平步青雲
精神焕发	精神煥發
博学多才	博學多才
痛快淋漓	痛快淋漓
言无不尽	言無不盡
不甘落后	不甘落後
退避三舍	退避三舍
决胜千里	決勝千里
动人心弦	動人心弦
高耸入云	高聳入雲
过眼烟云	過眼煙雲
不远千里	不遠千里
跳梁小丑	跳梁小醜
自学成才	自學成才
步调一致	步調一致
淡泊明志	淡泊明志
外强中干	外強中乾
言行一致	言行一致
进退维谷	進退維谷
乳臭未干	乳臭未乾
狼狈为奸	狼狽爲奸
鸿鹄之志	鴻鵠之志
裙带关系	裙帶關係
形单影只	形單影隻
自觉自愿	自覺自願
人各有志	人各有志
寄希望于	寄希望於
有根有据	有根有據
人心所向	人心所向
细嚼慢咽	細嚼慢嚥
全权代表	全權代表
交口称赞	交口稱讚
黄雀在后	黃雀在後
泰山北斗	泰山北斗
满天星斗	滿天星斗
望洋兴叹	望洋興歎
没精打采	沒精打采
血流如注	血流如注
老态龙钟	老態龍鍾
胸无大志	胸無大志
殊死搏斗	殊死搏鬥
机关算尽	機關算盡
年年有余	年年有餘
精明强干	精明強幹
难分难舍	難分難捨
乌兰巴托	烏蘭巴托
牛头马面	牛頭馬面
锐不可当	銳不可當
胸怀大志	胸懷大志
人海战术	人海戰術
间不容发	間不容髮
弹无虚发	彈無虛發
仁至义尽	仁至義盡
自卖自夸	自賣自誇
春风满面	春風滿面
油头粉面	油頭粉面
暮鼓晨钟	暮鼓晨鐘
画饼充饥	畫餅充飢
手不释卷	手不釋卷
鞍前马后	鞍前馬後
神不守舍	神不守舍
困兽犹斗	困獸猶鬥
大而无当	大而無當
壶口瀑布	壺口瀑布
毫无二致	毫無二致
惩前毖后	懲前毖後
雄姿英发	雄姿英發
洗手不干	洗手不幹
谬以千里	謬以千里
旧地重游	舊地重遊
鸿篇巨制	鴻篇巨制
虚有其表	虛有其表
幺麽小丑	幺麼小醜
力争上游	力爭上游
百折不回	百折不回
敢作敢当	敢作敢當
除恶务尽	除惡務盡
马革裹尸	馬革裹屍
势不可当	勢不可當
引而不发	引而不發
姑息养奸	姑息養奸
挂一漏万	掛一漏萬
徒有其表	徒有其表
无关大局	無關大局
进退失据	進退失據
沃野千里	沃野千里
依依惜别	依依惜別
豪情壮志	豪情壯志
英姿焕发	英姿煥發
出头露面	出頭露面
吴下阿蒙	吳下阿蒙
下不了台	下不了臺
暗箭难防	暗箭難防
查无实据	查無實據
赤地千里	赤地千里
比下有余	比下有餘
家贼难防	家賊難防
承先启后	承先啟後
喟然长叹	喟然長嘆
天从人愿	天從人願
封官许愿	封官許願
求神问卜	求神問卜
五马分尸	五馬分屍
真凭实据	真憑實據
成千成万	成千成萬
两相情愿	兩相情願
狐群狗党	狐群狗黨
如箭在弦	如箭在弦
人前人后	人前人後
一字一板	一字一板
败事有余	敗事有餘
人赃俱获	人贓俱獲
形影相吊	形影相弔
天渊之别	天淵之別
不知就里	不知就裏
秉烛夜游	秉燭夜遊
声如洪钟	聲如洪鐘
出乖露丑	出乖露醜
锋芒所向	鋒芒所向
相去无几	相去無幾
不知凡几	不知凡幾
置之脑后	置之腦後
信而有征	信而有徵
有凭有据	有憑有據
响遏行云	響遏行雲
生态标志	生態標誌
狐朋狗党	狐朋狗黨
墨迹未干	墨跡未乾
不足为据	不足爲據
满坑满谷	滿坑滿谷
观者如云	觀者如雲
子曰诗云	子曰詩云
言必有据	言必有據
鹊巢鸠占	鵲巢鳩佔
洞烛其奸	洞燭其奸
天遂人愿	天遂人願
童颜鹤发	童顏鶴髮
朋比为奸	朋比爲奸
民穷财尽	民窮財盡
鸠形鹄面	鳩形鵠面
生殖洄游	生殖洄游
明窗净几	明窗淨几
高情远致	高情遠致
以售其奸	以售其奸
东摇西摆	東搖西擺
防患于未然	防患於未然
后浪推前浪	後浪推前浪
几内亚比绍	幾內亞比紹
里约热内卢	里約熱內盧
杯酒释兵权	杯酒釋兵權
布加勒斯特	布加勒斯特
术业有专攻	術業有專攻
布尔什维克	布爾什維克
只怕有心人	只怕有心人
姜太公钓鱼	姜太公釣魚
只要功夫深	只要功夫深
蒙得维的亚	蒙得維的亞
布拉柴维尔	布拉柴維爾
里外不是人	裏外不是人
特别行政区	特別行政區
毛里塔尼亚	毛里塔尼亞
但愿人长久	但願人長久
亚里士多德	亞里士多德
十万八千里	十萬八千里
三个臭皮匠	三個臭皮匠
克里姆林宫	克里姆林宮
事后诸葛亮	事後諸葛亮
偏向虎山行	偏向虎山行
幼发拉底河	幼發拉底河
吹胡子瞪眼	吹鬍子瞪眼
赤道几内亚	赤道幾內亞
亚得里亚海	亞得里亞海
因斯布鲁克	因斯布魯克
五分钟热度	五分鐘熱度
救民于水火	救民於水火
一去不复返	一去不復返
庐山真面目	廬山真面目
雅鲁藏布江	雅魯藏布江
伊斯坦布尔	伊斯坦布爾
三思而后行	三思而後行
恩格尔系数	恩格爾係數
脚踏两只船	腳踏兩隻船
苛政猛于虎	苛政猛於虎
脚踩两只船	腳踩兩隻船
中国共产党	中國共產黨
资产负债表	資產負債表
一夫一妻制	一夫一妻制
小儿麻痹症	小兒麻痹症
坐山观虎斗	坐山觀虎鬥
一夫多妻制	一夫多妻制
稳坐钓鱼台	穩坐釣魚臺
索尔兹伯里	索爾茲伯里
闻道有先后	聞道有先後
天不从人愿	天不從人願
恶事传千里	惡事傳千里
万万没有想到	萬萬沒有想到
占有一席之地	佔有一席之地
万变不离其宗	萬變不離其宗
只许州官放火	只許州官放火
当面锣对面鼓	當面鑼對面鼓
内蒙古自治区	內蒙古自治區
一发不可收拾	一發不可收拾
立于不败之地	立於不敗之地
有志者事竟成	有志者事竟成
化干戈为玉帛	化干戈爲玉帛
博采众家之长	博採眾家之長
家丑不可外扬	家醜不可外揚
一个鼻孔出气	一個鼻孔出氣
陈谷子烂芝麻	陳穀子爛芝麻
乌兹别克斯坦	烏茲別克斯坦
鸡蛋里挑骨头	雞蛋裏挑骨頭
死马当活马医	死馬當活馬醫
矮子里选将军	矮子裏選將軍
理论联系实际	理論聯繫實際
一步一个脚印	一步一個腳印
事实胜于雄辩	事實勝於雄辯
哀莫大于心死	哀莫大於心死
毕其功于一役	畢其功於一役
以不变应万变	以不變應萬變
种种迹象表明	種種跡象表明
不问青红皂白	不問青紅皁白
好戏还在后头	好戲還在後頭
不分青红皂白	不分青紅皁白
海水不可斗量	海水不可斗量
前言不搭后语	前言不搭後語
天有不测风云	天有不測風雲
布宜诺斯艾利斯	布宜諾斯艾利斯
后天下之乐而乐	後天下之樂而樂
万丈高楼平地起	萬丈高樓平地起
巴布亚新几内亚	巴布亞新幾內亞
二万五千里长征	二萬五千里長征
一个巴掌拍不响	一個巴掌拍不響
一个萝卜一个坑	一個蘿蔔一個坑
黑云压城城欲摧	黑雲壓城城欲摧
心有余而力不足	心有餘而力不足
宁夏回族自治区	寧夏回族自治區
牵一发而动全身	牽一髮而動全身
长江后浪推前浪	長江後浪推前浪
眉毛胡子一把抓	眉毛鬍子一把抓
拒人于千里之外	拒人於千里之外
行百里者半九十	行百里者半九十
浪子回头金不换	浪子回頭金不換
近水楼台先得月	近水樓臺先得月
情人眼里出西施	情人眼裏出西施
山重水复疑无路	山重水複疑無路
不为五斗米折腰	不爲五斗米折腰
有缘千里来相会	有緣千里來相會
宰相肚里好撑船	宰相肚裏好撐船
解铃还须系铃人	解鈴還須繫鈴人
不识庐山真面目	不識廬山真面目
一年之计在于春	一年之計在於春
忠言逆耳利于行	忠言逆耳利於行
置之死地而后生	置之死地而後生
良药苦口利于病	良藥苦口利於病
酒逢知己千杯少	酒逢知己千杯少
一日之计在于晨	一日之計在於晨
置之死地而后快	置之死地而後快
放之四海而皆准	放之四海而皆準
饱汉不知饿汉饥	飽漢不知餓漢飢
尽信书则不如无书	盡信書則不如無書
青出于蓝而胜于蓝	青出於藍而勝於藍
半路杀出个程咬金	半路殺出個程咬金
当一天和尚撞一天钟	當一天和尚撞一天鐘
做一天和尚撞一天钟	做一天和尚撞一天鐘
